article_no,selling_price,inventory_quantity,w4,w3,w2,w1,4_weeks_sales,MOI,country
10887,12.99,7,0,0,0,0,0,99998,AU
10917,59.99,1,0,1,0,0,1,3,AU
11033,29.99,16,2,1,2,0,5,3.2,AU
10960,29.99,16,1,0,1,0,2,8,AU
11252,49.99,13,0,0,0,0,0,99998,AU
11005,59.99,13,0,0,0,0,0,99998,AU
11417,69.99,0,0,0,0,0,0,0,AU
11048,59.99,3,1,0,0,1,2,1.5,AU
11341,79.99,0,0,0,0,0,0,0,AU
10532,59.99,5,1,1,1,0,3,1.67,AU
10844,24.99,11,3,3,2,7,15,0.73,AU
11168,24.99,38,17,8,4,7,36,1.06,AU
10914,27.99,19,0,0,1,0,1,19,AU
11167,29.99,231,30,13,24,13,80,3.06,AU
11411,34.99,10,0,1,3,0,4,2.5,AU
11091,19.99,19,1,0,0,0,1,19,AU
11251,17.99,33,3,4,0,0,7,4.71,AU
11284,29.99,21,2,0,0,1,3,7,AU
11402,19.99,60,3,2,0,1,6,10.17,AU
18010,14.99,12,1,0,0,0,1,12,AU
11516,24.99,24,0,4,2,0,6,4,AU
11517,29.99,68,5,9,7,6,27,2.52,AU
11521,24.99,0,1,4,3,0,8,0.25,AU
11522,29.99,114,5,4,5,8,22,5.18,AU
11534,27.99,0,1,1,1,3,6,0,AU
11533,34.99,7,1,0,0,0,1,7,AU
11562,29.99,27,0,0,0,0,0,99998,AU
11567,39.99,5,1,0,2,0,3,1.67,AU
11568,44.99,13,2,1,3,0,6,2.17,AU
10840,39.99,15,0,0,0,0,0,99998,AU
10793,34.99,2,0,0,0,0,0,99998,AU
11525,79.99,32,3,1,2,0,6,5.33,AU
11528,74.99,4,1,0,0,0,1,4,AU
11267,34.99,19,3,0,2,3,8,2.38,AU
11261,34.99,5,1,2,0,0,3,2,AU
11566,34.99,256,14,10,9,5,38,6.76,AU
11572,39.99,20,5,3,3,1,12,1.67,AU
11605,39.99,9,3,2,0,3,8,1.25,AU
11635,29.99,9,3,0,2,0,5,1.8,AU
11538,19.99,15,0,0,0,0,0,99998,AU
11626,39.99,0,0,0,0,0,0,0,AU
11019,49.99,4,0,0,0,0,0,99998,AU
11354,99.99,5,0,1,2,0,3,1.67,AU
11615,99.99,7,0,0,1,0,1,7,AU
11648,69.99,13,1,1,0,0,2,6.5,AU
11633,94.99,0,0,0,0,0,0,0,AU
11444,16.99,10,0,0,0,2,2,5,AU
11574,21.99,14,1,0,1,2,4,3.5,AU
11663,69.99,6,0,0,0,0,0,99998,AU
11670,29.99,8,0,3,0,0,3,2.67,AU
11665,32.99,17,1,0,1,0,2,8.5,AU
11673,59.99,60,8,10,8,1,27,2.22,AU
11447,44.99,10,5,4,2,0,11,0.91,AU
11449,49.99,6,0,1,1,3,5,1.2,AU
11573,54.99,6,0,0,0,0,0,99998,AU
11002,59.99,9,0,0,0,0,0,99998,AU
11486,29.99,15,1,0,1,0,2,7.5,AU
11578,149.99,2,0,0,0,0,0,99998,AU
11607,39.99,23,2,3,1,0,6,3.83,AU
11694,49.99,0,0,0,0,0,0,0,AU
11634,44.99,8,1,1,1,0,3,2.67,AU
18025,14.99,4,0,0,0,0,0,99998,AU
18038,14.99,1,0,0,0,0,0,99998,AU
18026,14.99,6,0,0,1,0,1,6,AU
18037,14.99,6,0,0,0,0,0,99998,AU
18040,14.99,0,0,0,0,0,0,0,AU
18033,39.99,5,0,0,0,0,0,99998,AU
19998,9.99,19,2,4,3,6,15,1.53,AU
11696,29.99,0,0,0,1,0,1,0,AU
11703,14.99,3,2,0,0,1,3,1,AU
11687,14.99,11,0,0,0,0,0,99998,AU
11387,14.99,5,2,0,0,0,2,2.5,AU
10442,14.99,10,1,3,1,0,5,2,AU
11350,109.99,7,0,0,0,1,1,7,AU
11680,59.99,23,2,2,1,1,6,3.83,AU
11684,49.99,16,1,1,3,2,7,2.43,AU
11724,39.99,10,1,0,0,0,1,10,AU
11776,29.99,3,0,0,0,0,0,99998,AU
10905,59.99,0,0,0,0,0,0,0,AU
11369,49.99,0,0,0,0,0,0,0,AU
11729,49.99,6,0,2,1,0,3,2,AU
10789,34.99,5,0,0,0,0,0,99998,AU
11582,34.99,4,1,2,2,0,5,0.8,AU
11700,89.99,6,0,0,0,0,0,99998,AU
11764,7.99,10,0,0,0,0,0,99998,AU
11689,59.99,15,2,4,1,0,7,2.43,AU
11832,14.99,14,0,0,0,0,0,99998,AU
11831,14.99,5,0,0,0,0,0,99998,AU
11829,29.99,6,0,1,0,0,1,6,AU
11660,79.99,47,3,2,0,2,7,7.29,AU
10900,59.99,0,0,0,0,0,0,0,AU
11732,49.99,2,0,0,0,0,0,99998,AU
11052,14.99,0,0,0,0,0,0,0,AU
10891,11.99,0,0,0,0,0,0,0,AU
11804,89.99,0,0,2,0,0,2,0,AU
11798,74.99,3,1,0,0,0,1,3,AU
11543,89.99,3,0,0,0,0,0,99998,AU
11958,34.99,0,0,0,1,0,1,0,AU
11611,89.99,1,1,0,3,1,5,0.2,AU
11943,12.99,26,0,2,1,2,5,5.2,AU
11923,44.99,2,0,0,0,0,0,99998,AU
11924,49.99,12,0,0,1,0,1,12,AU
11904,49.99,10,0,1,1,0,2,5,AU
11797,8.99,9,1,0,1,0,2,4.5,AU
11705,19.99,2,0,1,0,1,2,1,AU
11937,29.99,15,2,3,4,0,9,1.67,AU
11909,59.99,5,7,6,5,0,18,0.28,AU
11953,69.99,15,0,0,3,0,3,5,AU
11907,37.99,17,0,2,0,0,2,8.5,AU
11950,49.99,10,1,2,1,0,4,2.5,AU
11679,34.99,23,2,1,2,0,5,4.6,AU
11944,69.99,10,1,1,1,0,3,3.33,AU
11618,39.99,5,0,0,0,0,0,99998,AU
11902,59.99,10,0,0,0,0,0,99998,AU
18028,14.99,4,0,0,1,0,1,4,AU
11994,19.99,12,0,3,3,2,8,1.5,AU
11541,119.99,5,0,0,0,0,0,99998,AU
11903,29.99,11,0,0,0,0,0,99998,AU
12013,49.99,19,5,0,3,0,8,2.38,AU
12060,24.99,18,0,0,1,0,1,18,AU
11983,39.99,26,1,1,4,0,6,4.33,AU
11577,199.99,2,0,0,0,0,0,99998,AU
11918,99.99,1,0,0,0,0,0,99998,AU
11917,99.99,1,0,0,0,0,0,99998,AU
11912,79.99,0,0,0,0,0,0,0,AU
11911,79.99,1,0,0,0,0,0,99998,AU
11914,79.99,1,0,0,0,0,0,99998,AU
11915,79.99,0,0,0,0,0,0,0,AU
11916,79.99,1,0,0,0,0,0,99998,AU
11913,79.99,1,0,0,0,0,0,99998,AU
11919,99.99,1,0,0,0,0,0,99998,AU
11922,99.99,0,0,0,0,0,0,0,AU
11920,99.99,1,0,0,0,0,0,99998,AU
11921,99.99,1,0,0,0,0,0,99998,AU
11529,14.99,18,2,0,0,0,2,9,AU
11765,7.99,9,0,0,0,0,0,99998,AU
12010,39.99,9,0,1,1,1,3,3,AU
11976,69.99,12,1,0,0,0,1,12,AU
11593,49.99,16,2,3,1,1,7,2.29,AU
11653,49.99,8,0,0,1,0,1,8,AU
11947,39.99,3,0,0,1,1,2,1.5,AU
11988,99.99,5,0,0,0,0,0,99998,AU
12105,49.99,5,1,1,0,0,2,2.5,AU
11834,59.99,0,0,0,0,0,0,0,AU
11707,49.99,5,0,0,0,0,0,99998,AU
12142,19.99,6,0,1,1,1,3,2,AU
12177,19.99,7,0,0,2,0,2,3.5,AU
12141,19.99,7,0,0,1,1,2,3.5,AU
12215,34.99,2,0,0,0,0,0,99998,AU
12227,79.99,2,0,0,0,0,0,99998,AU
12217,34.99,0,0,0,0,0,0,0,AU
10887,13.99,36,8,1,0,0,9,4,CA
10891,9.99,48,8,11,2,3,24,2.04,CA
11052,16.99,26,0,4,2,1,7,3.71,CA
11077,29.99,29,3,5,4,1,13,2.23,CA
11145,23.99,8,0,1,0,1,2,4,CA
11204,44.99,23,1,10,0,0,11,2.36,CA
11280,44.99,27,5,11,2,0,18,1.94,CA
10789,29.99,21,2,1,0,1,4,5.25,CA
10793,27.99,4,0,0,0,0,0,99998,CA
10840,29.99,36,5,4,4,0,13,2.77,CA
11033,27.99,43,5,8,2,0,15,2.87,CA
10960,24.99,85,20,19,7,4,50,1.7,CA
11252,39.99,42,1,0,0,0,1,42,CA
11002,59.99,1,0,2,1,0,3,0.33,CA
11005,59.99,1,0,0,0,0,0,99998,CA
11417,59.99,0,0,0,0,0,0,0,CA
11048,59.99,8,0,0,0,0,0,99998,CA
11364,49.99,5,0,0,0,1,1,5,CA
11369,29.99,7,2,2,1,0,5,1.4,CA
10900,49.99,16,0,3,1,0,4,4,CA
10905,39.99,2,0,0,0,0,0,99998,CA
11267,29.99,67,10,16,16,15,57,1.18,CA
11261,29.99,1,0,1,1,1,3,0.33,CA
11387,11.99,74,8,2,3,2,15,4.93,CA
10844,16.99,69,3,0,7,4,14,5,CA
10914,17.99,74,15,12,8,3,38,1.95,CA
11411,29.99,35,5,6,3,2,16,2.19,CA
11091,19.99,85,6,4,0,3,13,6.54,CA
11251,15.99,91,8,21,13,10,52,1.75,CA
11284,29.99,16,0,1,4,1,6,2.67,CA
19998,11.99,108,19,20,21,10,70,1.54,CA
11402,14.99,283,26,27,40,18,111,2.58,CA
10917,59.99,35,12,4,1,5,22,1.59,CA
11445,69.99,0,0,0,0,0,0,0,CA
11486,24.99,53,0,1,1,1,3,17.67,CA
10532,44.99,8,1,2,1,0,4,2,CA
11517,29.99,92,13,10,18,6,47,1.96,CA
11516,21.99,68,9,9,6,4,28,2.43,CA
11521,24.99,0,0,0,0,0,0,0,CA
11522,24.99,143,55,22,50,25,152,0.99,CA
11525,69.99,81,6,12,2,0,20,4.05,CA
11528,69.99,29,4,2,3,0,9,3.78,CA
11341,79.99,7,1,1,1,0,3,2.33,CA
11506,34.99,10,0,1,0,0,1,10,CA
11562,29.99,31,9,6,8,2,25,1.24,CA
11534,19.99,0,0,0,0,0,0,0,CA
11567,34.99,75,14,8,16,3,41,1.83,CA
11568,39.99,107,7,27,3,2,39,2.74,CA
11168,21.99,96,10,8,5,3,26,3.69,CA
11167,24.99,311,30,38,24,10,102,3.33,CA
18033,29.99,3,0,0,1,0,1,3,CA
11566,34.99,328,20,44,39,13,116,2.9,CA
11578,149.99,0,0,0,1,0,1,3,CA
11577,169.99,5,1,1,0,0,2,2.5,CA
11583,39.99,0,2,0,0,0,2,0,CA
11533,29.99,31,7,4,5,3,19,1.68,CA
11582,29.99,79,11,11,6,5,33,2.39,CA
11593,34.99,20,3,0,0,0,3,6.67,CA
11572,34.99,66,8,8,2,3,21,3.19,CA
11605,34.99,3,1,1,1,0,3,1,CA
11635,24.99,42,8,7,8,2,25,1.68,CA
11626,34.99,37,3,7,2,2,14,2.64,CA
11538,14.99,16,5,3,3,2,13,1.23,CA
11019,19.99,20,0,2,6,1,9,2.22,CA
11611,69.99,19,0,0,1,0,1,19,CA
10442,14.99,69,11,12,10,3,36,1.92,CA
11633,89.99,31,14,23,14,10,61,0.7,CA
11354,89.99,55,6,14,5,11,36,1.53,CA
11615,89.99,9,1,0,1,1,3,3,CA
11648,49.99,40,3,1,2,5,11,3.64,CA
11444,14.99,17,0,0,0,0,0,99998,CA
11574,17.99,4,1,0,0,0,1,4,CA
11670,19.99,33,7,5,3,13,28,1.21,CA
11663,59.99,11,0,0,0,0,0,99998,CA
11447,44.99,41,5,4,10,4,23,1.83,CA
11665,29.99,101,7,15,12,5,39,2.59,CA
11673,59.99,28,1,3,6,0,10,2.8,CA
11668,24.99,15,9,1,6,1,17,0.88,CA
11508,19.99,8,1,3,1,0,5,1.6,CA
11573,39.99,9,0,2,0,0,2,4.5,CA
11607,34.99,62,9,8,6,3,26,2.38,CA
11634,38.99,0,7,9,4,0,20,0,CA
11529,12.99,144,19,15,4,0,38,3.79,CA
11541,59.99,21,0,0,0,0,0,99998,CA
11543,49.99,13,3,1,2,2,8,1.75,CA
11694,37.99,10,0,1,0,0,1,10,CA
11689,49.99,28,13,10,8,8,39,0.72,CA
11687,11.99,6,0,1,0,0,1,6,CA
11696,24.99,22,0,2,0,2,4,5.5,CA
11703,11.99,19,14,4,14,10,42,0.48,CA
11350,79.99,11,1,1,4,0,6,1.83,CA
11680,44.99,63,9,9,11,5,34,1.85,CA
11684,39.99,50,8,4,7,0,19,2.63,CA
11724,17.99,11,0,1,0,3,4,2.75,CA
11814,29.99,23,0,2,6,0,8,2.88,CA
11813,49.99,15,1,2,1,0,4,3.75,CA
11726,29.99,34,4,0,5,1,10,3.4,CA
11798,49.99,43,0,0,0,1,1,43,CA
11810,49.99,6,0,0,0,0,0,99998,CA
11804,59.99,24,3,2,6,0,11,2.18,CA
11811,59.99,12,0,5,2,0,7,1.71,CA
11738,29.99,37,6,5,5,0,16,2.31,CA
11776,24.99,18,3,2,0,0,5,3.6,CA
11705,19.99,9,0,4,1,3,8,1.13,CA
11700,69.99,9,0,0,0,0,0,99998,CA
11832,12.99,40,1,1,1,2,5,8,CA
11831,12.99,26,2,3,4,1,10,2.6,CA
11898,27.99,0,0,0,0,0,0,0,CA
11899,29.99,5,3,0,1,1,5,1,CA
11927,49.99,1,3,2,1,0,6,0.17,CA
11930,39.99,4,0,1,1,0,2,2,CA
11934,29.99,0,0,0,0,0,0,0,CA
11938,44.99,6,0,1,1,0,2,7,CA
11449,49.99,42,8,6,6,1,21,2,CA
11660,69.99,22,1,9,4,2,16,1.38,CA
11829,24.99,6,2,0,4,2,8,0.75,CA
11766,17.99,17,0,0,1,0,1,17,CA
11839,29.99,0,0,1,0,0,1,0,CA
11958,29.99,35,0,2,2,0,4,8.75,CA
11993,54.99,12,0,0,0,1,1,12,CA
11924,44.99,0,2,0,1,0,3,0,CA
11923,44.99,10,1,0,0,0,1,10,CA
11904,44.99,18,2,2,2,0,6,3,CA
11909,59.99,17,2,4,3,1,10,1.7,CA
11953,59.99,28,1,3,5,3,12,2.33,CA
11764,6.99,8,0,0,0,0,0,99998,CA
11765,6.99,14,0,0,0,0,0,99998,CA
11796,6.99,12,1,0,1,0,2,6,CA
11797,7.99,13,0,0,0,0,0,99998,CA
11908,9.99,6,0,0,1,0,1,6,CA
11925,9.99,5,0,0,0,0,0,99998,CA
11902,44.99,8,0,2,1,2,5,1.6,CA
11907,24.99,0,1,2,0,0,3,0,CA
11937,34.99,32,3,15,5,0,23,1.48,CA
12047,44.99,13,0,2,2,0,4,3.25,CA
11669,64.99,44,10,2,1,1,14,3.14,CA
11994,17.99,204,29,32,11,2,74,3.31,CA
11935,69.99,4,0,0,0,0,0,99998,CA
11983,39.99,35,5,3,4,4,16,2.19,CA
11950,44.99,34,1,3,3,3,10,3.4,CA
11618,39.99,23,1,1,3,0,5,4.6,CA
11679,29.99,36,4,3,0,0,7,5.14,CA
11944,39.99,20,5,8,6,5,24,0.88,CA
12058,24.99,5,0,1,1,0,2,2.5,CA
11967,79.99,25,6,3,3,0,12,2.08,CA
11913,59.99,7,0,0,0,0,0,99998,CA
11911,59.99,5,0,1,0,0,1,5,CA
11912,59.99,8,0,0,0,0,0,99998,CA
11914,69.99,8,0,0,0,0,0,99998,CA
11915,69.99,7,0,0,0,0,0,99998,CA
11916,69.99,7,0,0,0,0,0,99998,CA
11729,29.99,43,6,8,3,2,19,2.26,CA
11043,24.99,9,0,0,0,0,0,99998,CA
11947,29.99,18,3,2,3,0,8,2.38,CA
11653,39.99,60,8,11,5,1,25,2.4,CA
12060,19.99,0,0,0,0,0,0,0,CA
12010,39.99,58,8,18,9,5,40,1.48,CA
11917,69.99,9,0,0,0,0,0,99998,CA
11918,69.99,6,0,0,0,0,0,99998,CA
11919,69.99,1,0,0,2,0,2,0.5,CA
11920,79.99,12,0,0,0,0,0,99998,CA
11921,79.99,6,0,0,0,0,0,99998,CA
11922,79.99,4,0,0,0,0,0,99998,CA
12013,39.99,75,12,11,6,3,32,2.34,CA
11903,14.99,0,5,4,8,0,17,0,CA
12091,34.99,9,2,0,0,0,2,4.5,CA
12092,49.99,10,0,2,0,0,2,5,CA
12093,79.99,7,2,1,0,0,3,2.33,CA
12094,69.99,11,0,0,2,0,2,5.5,CA
12095,44.99,14,0,0,1,0,1,14,CA
12096,27.99,16,0,1,1,5,7,2.29,CA
12090,39.99,2,0,0,0,0,0,99998,CA
11988,59.99,0,0,1,0,0,1,0,CA
11987,54.99,16,0,1,0,0,1,16,CA
11989,54.99,21,0,1,1,0,2,10.5,CA
12149,39.99,9,0,0,0,1,1,9,CA
12156,39.99,10,0,0,0,0,0,99998,CA
11976,49.99,30,1,2,2,1,6,5,CA
11707,39.99,7,0,1,0,0,1,7,CA
11834,69.99,11,0,0,0,1,1,11,CA
12105,49.99,19,1,1,1,1,4,4.75,CA
12174,79.99,6,0,0,0,0,0,99998,CA
12128,6.99,10,0,0,0,0,0,99998,CA
12129,7.99,10,0,0,0,0,0,99998,CA
12177,16.99,26,0,2,1,0,3,8.67,CA
12141,16.99,22,2,3,4,0,9,2.44,CA
12142,16.99,21,4,2,3,1,10,2.1,CA
10716,6.99,9,0,1,0,0,1,9,CA
12140,8.99,10,0,0,0,0,0,99998,CA
12166,29.99,10,0,0,0,0,0,99998,CA
11816,69.99,11,0,0,0,0,0,99998,CA
12139,7.99,10,0,0,0,0,0,99998,CA
11304,119.99,36,0,0,0,0,0,99998,CA
11305,119.99,34,0,0,2,0,2,17,CA
11303,119.99,19,0,0,0,1,1,23,CA
11298,99.99,5,0,0,0,0,0,99998,CA
11299,99.99,3,0,0,0,0,0,99998,CA
10103,99.99,0,0,0,0,0,0,0,CA
10887,8.99,53,6,6,1,1,14,3.79,DE
10891,5.99,109,11,4,6,2,23,4.74,DE
10786,19.99,57,6,6,9,6,27,2.11,DE
10790,19.99,39,23,5,4,3,35,1.11,DE
10761,24.99,69,11,13,3,2,29,2.38,DE
10958,17.99,158,27,24,32,16,99,1.64,DE
10840,26.99,32,3,1,0,0,4,8,DE
11394,19.99,157,27,8,11,9,55,2.87,DE
11033,24.99,21,3,5,3,4,15,1.4,DE
10960,19.99,2,5,1,11,3,20,0.1,DE
11252,39.99,36,6,3,0,0,9,4,DE
10999,39.99,26,0,0,7,1,8,3.25,DE
11003,49.99,17,0,0,1,0,1,17,DE
11005,49.99,9,3,5,0,0,8,1.13,DE
11340,59.99,0,10,1,0,0,11,0,DE
11363,34.99,90,21,8,9,4,42,2.14,DE
10965,19.99,15,0,1,1,0,2,7.5,DE
10901,34.99,14,0,6,0,1,7,2,DE
11262,21.99,255,29,29,36,22,116,2.23,DE
11181,19.99,102,18,9,9,11,47,2.17,DE
11387,8.99,98,12,14,14,6,46,2.15,DE
10844,14.99,70,1,4,2,1,8,8.75,DE
11168,16.99,279,35,47,26,15,123,2.45,DE
10914,14.99,131,10,10,11,0,31,4.23,DE
11167,19.99,482,83,48,81,31,243,2.1,DE
11411,17.99,44,5,12,6,2,25,1.76,DE
11091,14.99,98,11,11,9,2,33,2.97,DE
11251,9.99,64,9,6,8,7,30,2.13,DE
11284,19.99,66,4,10,6,2,22,3,DE
19998,6.99,113,1,45,21,28,95,1.12,DE
11402,9.99,296,44,23,39,27,133,2.3,DE
11420,49.99,7,0,2,0,1,3,2.33,DE
11415,59.99,19,0,4,3,1,8,2.38,DE
18010,9.99,6,2,4,0,1,7,0.86,DE
11517,24.99,161,17,4,2,3,26,6.19,DE
11516,16.99,88,12,9,9,1,31,2.84,DE
11484,17.99,123,0,1,11,10,22,5.59,DE
11521,17.99,9,5,23,22,20,70,0.13,DE
11522,24.99,508,68,67,89,12,236,2.32,DE
11526,34.99,98,16,16,9,7,48,2.04,DE
11523,44.99,168,64,64,28,14,170,1.13,DE
11503,29.99,26,7,5,4,11,27,0.96,DE
11534,17.99,47,2,6,4,4,16,2.94,DE
11533,19.99,47,8,6,6,0,20,2.35,DE
11562,19.99,42,5,8,6,3,22,1.95,DE
11567,29.99,105,14,22,10,11,57,1.84,DE
11568,27.99,39,6,10,10,5,31,1.26,DE
18028,9.99,12,0,2,3,1,6,2,DE
11351,29.99,98,13,17,9,4,43,2.28,DE
18033,29.99,9,0,1,1,1,3,3,DE
11381,39.99,15,20,0,2,2,24,0.63,DE
11341,59.99,6,1,0,3,0,4,1.5,DE
11582,21.99,29,4,5,4,2,15,1.93,DE
11593,24.99,60,0,7,9,2,18,3.33,DE
11572,27.99,113,14,10,5,5,34,3.32,DE
11417,59.99,3,0,0,0,0,0,99998,DE
11577,149.99,4,0,0,0,0,0,99998,DE
11578,119.99,4,1,0,0,0,1,4,DE
11052,9.99,37,2,0,1,1,4,9.25,DE
11525,39.99,27,3,0,5,4,12,2.25,DE
10789,19.99,22,0,0,1,0,1,22,DE
10917,59.99,18,0,0,0,2,2,9,DE
11048,49.99,7,1,1,0,0,2,3.5,DE
11364,39.99,29,0,0,0,0,0,99998,DE
11019,19.99,26,1,0,1,0,2,13,DE
11471,24.99,258,81,60,68,74,283,0.92,DE
11606,29.99,39,15,9,34,16,74,0.53,DE
11604,24.99,3,11,2,2,0,15,0.2,DE
11624,29.99,11,4,5,3,6,18,0.61,DE
11635,16.99,129,9,7,3,4,23,5.65,DE
11353,64.99,123,14,11,11,6,42,2.93,DE
11610,59.99,130,14,10,5,6,35,3.71,DE
11612,74.99,269,53,55,52,21,181,1.59,DE
11538,12.99,39,1,2,3,1,7,5.57,DE
11647,39.99,0,5,2,6,2,15,0,DE
11649,44.99,203,25,33,35,10,103,2.17,DE
10442,11.99,81,17,8,10,11,46,1.76,DE
11626,29.99,15,1,0,1,2,4,3.75,DE
18026,9.99,6,1,2,0,0,3,2,DE
11620,49.99,38,4,4,5,8,21,1.81,DE
11419,19.99,49,5,14,9,0,28,1.75,DE
11671,14.99,105,6,9,10,15,40,2.63,DE
18025,9.99,8,2,3,2,0,7,1.14,DE
11444,9.99,43,0,3,2,0,5,8.6,DE
11574,9.99,71,9,7,7,2,25,2.84,DE
11611,49.99,16,1,4,0,2,7,2.29,DE
11077,17.99,220,17,5,4,2,28,8.21,DE
11354,69.99,8,2,1,1,0,4,2,DE
11456,34.99,38,7,7,10,6,30,1.27,DE
11666,21.99,201,38,43,52,30,163,1.25,DE
11449,34.99,1,1,2,1,2,6,0.33,DE
11447,34.99,115,19,11,19,15,64,1.8,DE
11673,39.99,24,2,2,1,3,8,3,DE
11529,6.79,180,15,38,17,9,79,2.28,DE
11573,34.99,24,1,2,0,0,3,8,DE
11489,54.99,6,0,0,0,0,0,99998,DE
11569,24.99,16,6,14,6,5,31,0.52,DE
11608,27.99,163,31,23,24,15,93,1.86,DE
11634,29.99,0,0,0,0,0,0,0,DE
11713,34.99,140,19,16,24,11,70,2,DE
11541,29.99,7,1,2,0,1,4,1.75,DE
11543,39.99,26,1,8,3,2,14,1.86,DE
11145,14.99,40,1,7,6,5,19,2.11,DE
11367,24.99,11,2,1,0,0,3,3.67,DE
18040,9.99,6,0,0,0,1,1,6,DE
18038,9.99,6,0,0,0,0,0,99998,DE
18037,9.99,0,1,1,1,0,3,0,DE
10793,19.99,0,0,0,0,0,0,0,DE
11528,34.99,11,0,2,1,0,3,3.67,DE
11615,69.99,7,0,1,0,0,1,7,DE
11665,19.99,31,0,0,1,0,1,31,DE
10532,39.99,10,1,0,3,0,4,2.5,DE
11689,34.99,11,2,1,3,2,8,1.38,DE
11648,44.99,17,0,0,0,0,0,99998,DE
11633,79.99,5,0,0,0,1,1,5,DE
11486,17.99,19,0,2,2,1,5,3.8,DE
11267,24.99,12,1,0,0,1,2,6,DE
11261,24.99,0,0,0,0,0,0,0,DE
11607,29.99,15,0,2,1,0,3,5,DE
11690,29.99,76,6,9,13,12,40,1.9,DE
11687,8.99,35,0,0,0,0,0,99998,DE
11507,19.99,0,0,0,16,0,16,0,DE
11699,17.99,83,8,5,3,7,23,3.61,DE
11703,9.99,211,42,31,33,19,125,1.79,DE
11681,39.99,0,1,0,0,0,1,0,DE
11685,34.99,138,20,23,49,10,102,1.36,DE
11724,14.99,36,2,0,3,0,5,7.2,DE
11349,49.99,0,9,16,4,0,29,0,DE
11725,19.99,52,4,11,4,3,22,2.45,DE
11728,24.99,65,3,5,6,2,16,4.06,DE
11729,19.99,6,0,1,0,0,1,6,DE
11605,29.99,9,1,0,0,0,1,9,DE
11041,24.99,12,0,0,0,1,1,12,DE
11277,34.99,12,0,0,0,0,0,99998,DE
11847,24.99,13,0,0,0,0,0,99998,DE
11737,24.99,132,5,18,16,4,43,3.07,DE
18043,34.99,1,0,1,0,0,1,1,DE
18055,34.99,0,0,0,0,0,0,0,DE
18046,9.99,4,1,0,1,1,3,1.33,DE
18047,9.99,0,0,0,0,0,0,0,DE
18049,9.99,0,0,0,0,0,0,0,DE
11778,16.99,0,0,0,0,0,0,0,DE
11204,34.99,9,2,0,0,2,4,2.25,DE
11881,19.99,0,0,0,0,0,0,0,DE
11875,19.99,15,1,0,0,0,1,15,DE
11897,29.99,2,0,0,0,0,0,99998,DE
11886,29.99,5,0,0,0,0,0,99998,DE
10818,34.99,18,7,1,0,0,8,2.25,DE
11701,49.99,0,4,7,4,1,16,0,DE
11765,3.99,17,0,1,1,1,3,5.67,DE
11790,14.99,61,9,9,15,6,39,1.59,DE
11705,16.99,42,4,3,0,1,8,5.25,DE
11796,4.99,18,0,0,0,0,0,99998,DE
11797,4.99,17,0,1,0,0,1,17,DE
10896,34.99,9,0,0,1,2,3,3,DE
11672,16.99,153,30,35,30,28,123,1.26,DE
11832,8.99,40,3,1,5,1,10,4,DE
11831,9.99,46,4,6,6,0,16,2.88,DE
11863,19.99,24,1,1,0,0,2,12,DE
11869,19.99,2,0,0,1,0,1,2,DE
11892,24.99,4,0,0,0,0,0,99998,DE
11726,19.99,9,1,0,0,0,1,9,DE
11738,19.99,6,0,1,0,0,1,6,DE
11663,49.99,8,1,0,1,0,2,4,DE
11684,34.99,43,1,3,5,2,11,4,DE
11445,59.99,1,0,0,0,0,0,99998,DE
11280,34.99,10,0,0,0,0,0,99998,DE
11369,24.99,6,0,0,0,0,0,99998,DE
10900,34.99,11,1,0,0,0,1,11,DE
11506,29.99,17,0,0,0,0,0,99998,DE
11696,17.99,2,0,0,0,0,0,99998,DE
11002,49.99,2,4,0,0,0,4,0.5,DE
11776,17.99,20,1,1,1,0,3,6.67,DE
11694,24.99,12,0,0,0,0,0,99998,DE
11422,49.99,13,0,1,0,0,1,13,DE
11062,39.99,2,0,0,0,0,0,99998,DE
11350,49.99,0,0,0,1,1,2,0,DE
11791,19.99,3,0,0,0,0,0,99998,DE
11862,19.99,0,0,0,0,0,0,0,DE
11868,19.99,0,0,0,0,0,0,0,DE
11889,14.99,5,1,0,0,1,2,2.5,DE
11895,29.99,6,0,0,0,0,0,99998,DE
11890,29.99,10,0,1,0,0,1,10,DE
11873,9.99,10,0,0,0,0,0,99998,DE
11872,19.99,7,0,0,1,0,1,7,DE
11874,19.99,6,0,0,0,0,0,99998,DE
11700,49.99,8,3,0,0,0,3,2.67,DE
11878,19.99,9,1,1,0,0,2,4.5,DE
11879,14.99,18,0,0,0,0,0,99998,DE
11929,29.99,10,0,1,0,0,1,10,DE
11805,24.99,38,5,3,3,1,12,3.17,DE
11799,24.99,45,4,1,2,2,9,5,DE
11829,22.99,9,2,3,0,4,9,1,DE
11810,34.99,4,1,0,0,0,1,4,DE
11811,49.99,7,0,0,1,0,1,7,DE
11804,39.99,7,0,0,0,0,0,99998,DE
11798,34.99,4,0,0,0,1,1,4,DE
11766,19.99,12,0,1,1,1,3,4,DE
11860,19.99,12,0,1,0,0,1,12,DE
11861,9.99,5,0,1,0,0,1,5,DE
11866,19.99,10,0,0,0,0,0,99998,DE
11896,24.99,9,0,1,0,0,1,9,DE
11931,14.99,8,0,0,0,0,0,99998,DE
11761,39.99,5,1,1,0,0,2,2.5,DE
11762,34.99,6,0,0,0,0,0,99998,DE
11767,44.99,1,0,1,2,0,3,0.33,DE
11884,29.99,0,0,0,0,0,0,0,DE
11964,19.99,17,0,0,0,0,0,99998,DE
11965,29.99,4,0,0,0,0,0,99998,DE
11966,29.99,10,1,0,0,0,1,10,DE
11867,14.99,10,0,0,0,0,0,99998,DE
11660,59.99,11,0,0,3,1,4,2.75,DE
11680,34.99,24,2,5,2,1,10,2.4,DE
11841,24.99,49,3,9,10,5,27,1.81,DE
11839,29.99,8,0,1,0,0,1,8,DE
11958,16.99,9,0,0,0,0,0,99998,DE
11923,29.99,29,1,8,3,1,13,2.23,DE
11924,29.99,38,3,4,2,1,10,3.8,DE
11904,34.99,14,0,0,0,1,1,14,DE
11837,12.99,64,6,8,5,2,21,3.14,DE
11943,7.99,32,5,7,5,1,18,1.78,DE
11996,29.99,8,1,0,0,0,1,8,DE
11997,19.99,0,0,0,0,0,0,0,DE
11760,29.99,7,0,0,0,3,3,2.33,DE
11909,39.99,7,2,1,2,1,6,1.17,DE
11953,39.99,15,3,0,1,0,4,3.75,DE
11925,9.99,0,0,0,0,0,0,0,DE
11908,9.99,23,0,0,0,0,0,99998,DE
11907,19.99,17,1,1,1,1,4,4.25,DE
11937,24.99,135,36,35,37,27,135,1.04,DE
11928,29.99,11,0,0,0,0,0,99998,DE
11999,34.99,1,0,0,0,0,0,99998,DE
11998,29.99,1,1,2,0,0,3,0.33,DE
11202,34.99,28,0,1,0,0,1,28,DE
11670,17.99,11,0,0,0,1,1,11,DE
11993,49.99,13,0,0,0,0,0,99998,DE
11659,99.99,6,1,3,1,4,9,0.67,DE
11935,29.99,4,0,0,5,1,6,0.67,DE
11669,49.99,5,0,1,0,0,1,5,DE
11900,49.99,154,29,18,14,14,75,2.05,DE
11946,29.99,96,6,10,13,5,34,2.82,DE
11786,19.99,85,7,1,6,3,17,5,DE
11994,12.99,228,17,24,61,12,114,1.96,DE
11619,29.99,47,4,4,5,1,14,3.36,DE
11944,29.99,22,4,6,2,0,12,1.83,DE
11618,34.99,21,0,0,0,0,0,99998,DE
11902,39.99,6,0,0,1,0,1,6,DE
11679,19.99,17,1,0,1,0,2,8.5,DE
11950,27.99,22,1,2,0,5,8,2.75,DE
11949,29.99,104,9,5,8,9,31,3.35,DE
11947,29.99,19,0,0,0,0,0,99998,DE
11968,59.99,73,6,8,5,10,29,2.52,DE
11960,24.99,109,11,16,13,5,45,2.42,DE
11653,33.99,26,1,0,0,1,2,13,DE
12013,34.99,71,11,6,16,10,43,1.65,DE
11983,29.99,77,9,9,10,6,34,2.26,DE
10910,29.99,2,0,0,0,0,0,99998,DE
12060,17.99,44,2,2,1,3,8,5.5,DE
12063,29.99,19,0,0,0,0,0,99998,DE
12112,34.99,4,1,3,0,2,6,0.67,DE
11903,9.99,113,5,15,16,19,55,2.05,DE
12126,19.99,8,0,0,2,0,2,4,DE
12125,9.99,11,2,1,0,0,3,3.67,DE
11988,89.99,5,0,0,0,0,0,99998,DE
11989,49.99,4,0,0,0,0,0,99998,DE
12136,29.99,7,0,0,0,0,0,99998,DE
12113,49.99,12,0,0,0,0,0,99998,DE
11992,39.99,44,12,4,7,3,26,1.69,DE
12137,9.99,7,0,0,0,0,0,99998,DE
11987,84.99,5,0,0,0,0,0,99998,DE
12152,29.99,5,0,0,0,0,0,99998,DE
12153,49.99,6,0,0,0,1,1,6,DE
12155,29.99,10,0,0,0,0,0,99998,DE
12159,29.99,5,0,0,0,0,0,99998,DE
12160,24.99,0,0,0,0,0,0,0,DE
12162,29.99,1,0,0,1,1,2,0.5,DE
11976,49.99,33,0,0,1,0,1,33,DE
12011,29.99,38,6,9,7,7,29,1.31,DE
11952,26.99,86,5,11,3,7,26,3.31,DE
11834,49.99,8,0,0,0,0,0,99998,DE
11707,39.99,19,1,0,0,0,1,19,DE
11764,4.99,17,0,0,0,0,0,99998,DE
11833,39.99,66,3,6,8,3,20,3.35,DE
12105,34.99,3,1,0,1,0,2,1.5,DE
11656,19.99,38,0,0,0,0,0,99998,DE
11835,24.99,34,1,1,1,0,3,11.33,DE
12129,3.99,6,1,0,0,0,1,7,DE
12128,3.99,10,0,0,0,0,0,99998,DE
11318,34.99,12,0,0,0,0,0,99998,DE
12141,14.99,36,3,4,5,0,12,3,DE
12177,14.99,11,0,1,0,5,6,2,DE
12142,14.99,48,2,2,2,0,6,8,DE
11319,64.99,10,0,0,2,0,2,5,DE
10887,5.99,34,1,2,2,2,7,4.86,ES
10891,5.99,18,4,3,5,0,12,1.5,ES
11077,17.99,45,14,5,12,1,32,1.41,ES
10788,22.99,49,9,6,5,1,21,2.33,ES
11288,34.99,0,1,2,3,2,8,0,ES
11387,9.99,58,9,7,10,6,32,1.81,ES
10844,16.99,9,3,1,2,3,9,1,ES
11168,16.99,374,63,70,97,75,305,1.21,ES
10914,19.99,21,5,3,5,2,15,1.4,ES
11167,19.99,297,32,62,81,58,233,1.22,ES
11284,19.99,19,3,1,0,5,9,2.11,ES
11091,16.99,22,3,0,2,0,5,4.4,ES
11251,12.99,105,7,8,8,8,31,3.39,ES
19998,6.99,55,1,5,9,22,37,1.49,ES
11411,19.99,57,6,7,4,9,26,2.19,ES
11263,24.99,159,30,29,35,15,109,1.54,ES
11182,24.99,66,16,14,25,23,78,0.87,ES
11516,15.99,70,10,9,27,12,58,1.22,ES
11517,24.99,152,33,50,74,24,181,0.84,ES
11521,24.99,0,10,10,3,0,23,0,ES
11522,21.99,109,13,12,9,29,63,1.73,ES
11534,16.99,34,0,3,5,3,11,3.09,ES
11533,19.99,34,5,0,0,1,6,5.67,ES
11562,19.99,77,3,2,4,2,11,7,ES
11567,29.99,47,19,9,9,9,46,1.02,ES
11568,34.99,13,2,1,3,1,7,1.86,ES
11575,49.99,57,18,20,20,11,69,0.83,ES
11595,13.99,136,11,17,13,15,56,2.43,ES
11582,24.99,33,0,21,2,1,24,1.38,ES
11402,13.99,182,44,49,24,21,138,1.43,ES
11572,27.99,61,4,8,3,5,20,3.05,ES
18010,9.99,4,1,0,0,0,1,4,ES
18028,9.99,4,0,0,0,2,2,2,ES
11630,49.99,34,0,2,1,0,3,11.33,ES
11019,14.99,1,2,5,4,7,18,0.06,ES
11635,19.99,66,1,6,11,4,22,3,ES
11614,64.99,22,4,2,2,5,13,1.69,ES
11545,19.99,93,24,4,13,12,53,1.75,ES
11538,15.99,26,3,5,6,2,16,1.63,ES
10442,11.99,57,4,7,8,6,25,2.28,ES
11052,9.99,16,0,1,0,2,3,5.33,ES
18026,9.99,3,0,0,0,1,1,3,ES
11444,11.99,17,0,1,0,0,1,17,ES
11574,14.99,17,2,2,1,2,7,2.43,ES
18025,9.99,4,0,1,0,1,2,2,ES
11447,34.99,25,0,4,5,1,10,2.5,ES
11449,39.99,29,2,3,3,3,11,2.64,ES
11458,29.99,131,7,18,15,21,61,2.15,ES
11712,34.99,22,0,2,2,0,4,5.5,ES
11709,15.99,101,14,9,20,12,55,1.84,ES
11529,9.99,35,3,11,0,0,14,2.5,ES
11596,44.99,30,1,1,1,2,5,6,ES
11573,29.99,3,3,1,7,3,14,0.21,ES
11634,39.99,0,4,3,11,7,25,0.04,ES
11705,16.99,20,0,0,0,1,1,20,ES
11687,9.99,78,1,0,3,0,4,19.5,ES
11510,24.99,30,0,0,1,0,1,30,ES
11703,12.99,164,12,7,17,11,47,3.49,ES
11748,17.99,40,2,4,11,6,23,1.87,ES
11724,11.99,6,1,0,0,1,2,3,ES
11818,29.99,27,1,3,6,3,13,2.08,ES
11771,14.99,40,1,3,1,0,5,8,ES
11715,39.99,118,23,37,55,58,173,0.65,ES
11636,54.99,52,4,16,7,8,35,1.49,ES
11819,44.99,10,5,5,5,7,22,0.45,ES
11711,15.99,8,3,7,6,12,28,0.29,ES
10792,19.99,0,0,0,0,0,0,0,ES
11751,79.99,26,6,2,6,11,25,1.04,ES
11419,17.99,11,0,0,5,0,5,2.2,ES
11851,22.99,17,4,1,2,0,7,2.43,ES
11852,64.99,5,0,0,0,1,1,5,ES
11856,19.99,21,1,0,0,0,1,21,ES
11857,19.99,9,0,1,4,0,5,1.8,ES
11888,14.99,5,1,0,3,1,5,1,ES
11290,34.99,16,1,3,0,0,4,4,ES
11854,39.99,15,0,0,3,1,4,3.75,ES
11855,34.99,4,0,0,1,1,2,2,ES
10898,31.99,20,2,0,0,0,2,10,ES
11372,22.99,19,0,0,0,0,0,99998,ES
11765,5.99,3,0,0,0,0,0,99998,ES
11764,5.99,1,0,0,0,0,0,99998,ES
11796,5.99,3,0,0,0,0,0,99998,ES
11797,6.99,5,0,0,0,0,0,99998,ES
11832,11.99,12,0,3,0,0,3,4,ES
11831,11.99,16,0,0,1,1,2,8,ES
10903,31.99,18,0,0,0,0,0,99998,ES
18043,29.99,0,0,0,0,0,0,0,ES
18055,29.99,0,0,0,0,0,0,0,ES
18047,9.99,0,0,0,0,0,0,0,ES
18046,9.99,5,0,0,0,0,0,99998,ES
18037,8.99,4,0,0,0,0,0,99998,ES
18038,8.99,2,0,0,0,0,0,99998,ES
18040,8.99,4,0,0,0,0,0,99998,ES
11145,15.99,5,0,2,2,1,5,1,ES
11766,17.99,6,0,0,0,0,0,99998,ES
11859,19.99,15,0,1,0,1,2,7.5,ES
11865,19.99,1,0,0,2,1,3,0.33,ES
11894,19.99,17,0,0,1,2,3,5.67,ES
11933,19.99,14,0,0,0,0,0,99998,ES
11982,49.99,0,0,0,0,2,2,0,ES
11806,52.99,12,3,0,4,0,7,1.71,ES
11823,39.99,35,2,30,1,0,33,1.06,ES
11590,54.99,60,7,3,13,4,27,2.22,ES
11800,39.99,18,0,1,1,0,2,9,ES
11979,39.99,25,0,0,0,0,0,99998,ES
11904,34.99,4,1,0,1,0,2,2,ES
11923,34.99,8,0,0,0,0,0,99998,ES
11924,39.99,5,0,0,0,0,0,99998,ES
11723,16.99,33,3,4,7,10,24,1.42,ES
11943,9.99,5,2,0,0,0,2,2.5,ES
11925,5.99,0,0,0,0,0,0,0,ES
11908,9.99,3,0,0,0,0,0,99998,ES
11907,22.99,7,0,0,0,1,1,7,ES
11995,44.99,27,0,1,0,1,2,13.5,ES
11937,26.99,22,14,12,10,8,44,0.5,ES
11909,34.99,0,4,6,10,1,21,0,ES
11994,13.99,330,7,7,3,2,19,17.37,ES
11846,22.99,24,1,1,1,0,3,8,ES
11618,29.99,2,0,1,2,0,3,0.67,ES
11983,29.99,18,3,4,7,2,16,1.13,ES
12013,34.99,26,1,1,1,2,5,5.2,ES
11903,9.99,10,0,1,3,1,5,2,ES
12060,16.99,7,3,0,1,0,4,1.75,ES
11957,9.99,50,8,16,17,5,46,1.09,ES
11289,34.99,3,0,0,1,0,1,3,ES
12076,24.99,34,1,3,0,4,8,4.25,ES
12081,14.99,43,12,3,4,7,26,1.65,ES
12154,39.99,6,0,0,0,0,0,99998,ES
12161,39.99,9,0,0,0,0,0,99998,ES
12109,24.99,47,4,5,17,7,33,1.42,ES
12129,5.99,5,0,0,0,0,0,99998,ES
12128,5.99,5,0,0,0,0,0,99998,ES
12142,14.99,25,2,4,6,3,15,1.67,ES
12141,14.99,26,2,1,3,8,14,1.86,ES
12177,14.99,31,2,4,3,2,11,2.82,ES
10887,11.99,39,1,1,2,1,5,7.8,FR
10891,6.99,14,9,8,11,12,40,1.35,FR
11052,10.99,4,9,3,3,1,16,2.81,FR
11077,19.99,161,8,2,8,10,28,5.75,FR
11145,16.99,24,1,1,2,3,7,3.57,FR
10787,27.99,16,0,1,1,2,4,4,FR
10645,24.99,61,3,5,5,6,19,3.21,FR
10959,19.99,168,18,18,16,13,65,2.58,FR
11004,49.99,67,7,6,5,3,21,3.19,FR
11387,9.99,43,5,2,4,3,14,4,FR
11168,16.99,120,13,8,19,6,46,2.63,FR
10844,17.99,54,19,8,7,0,34,1.59,FR
11167,21.99,325,59,41,28,28,156,2.26,FR
10914,19.99,31,0,0,0,0,0,99998,FR
11091,17.9,52,6,15,23,9,53,2.49,FR
11251,14.99,169,26,41,32,21,120,2,FR
11284,21.99,71,2,2,6,3,13,5.46,FR
19998,6.99,139,15,14,13,10,52,2.71,FR
11411,21.99,32,5,5,5,5,20,1.65,FR
11402,12.99,14,4,10,6,10,30,1.8,FR
18010,10.99,1,0,2,0,0,2,0.5,FR
11516,19.99,107,15,7,2,0,24,4.46,FR
11517,24.99,193,16,5,1,0,22,8.77,FR
11521,16.99,0,0,0,0,0,0,0,FR
11522,24.99,156,45,22,9,14,90,3.04,FR
11534,19.99,0,10,0,0,0,10,0,FR
11533,24.99,14,0,0,0,0,0,99998,FR
11560,49.99,62,8,9,8,4,29,2.14,FR
11563,12.99,30,2,7,3,5,17,1.76,FR
11562,23.99,21,0,0,0,0,0,99998,FR
11567,29.99,49,7,9,3,4,23,2.13,FR
11568,34.99,14,3,4,0,0,7,2,FR
18028,10.99,9,2,0,0,0,2,4.5,FR
11582,24.99,44,1,0,0,1,2,22,FR
11572,26.99,33,10,10,10,4,34,2.15,FR
11571,24.99,0,0,0,0,0,0,0,FR
11364,39.99,2,0,0,0,0,0,99998,FR
11639,39.99,45,10,12,12,14,48,0.94,FR
11627,29.99,52,4,1,4,3,12,4.33,FR
11635,19.99,77,2,2,2,2,8,9.63,FR
11428,69.99,37,5,7,5,1,18,2.06,FR
11504,29.99,0,0,0,0,0,0,0,FR
11538,14.99,8,3,2,1,1,7,6.86,FR
10442,10.99,35,7,4,0,3,14,2.5,FR
11652,21.99,88,10,1,4,2,17,5.18,FR
11601,24.99,48,9,9,8,4,30,1.63,FR
18026,10.99,2,0,0,0,0,0,99998,FR
18025,10.99,2,0,0,0,0,0,99998,FR
11588,49.99,77,13,20,5,8,46,1.67,FR
11447,39.99,19,2,4,5,2,13,3,FR
11449,39.99,14,1,1,2,1,5,2.8,FR
11472,29.99,174,31,43,37,19,130,1.39,FR
11573,37.99,13,0,0,0,0,0,99998,FR
11634,29.99,0,3,2,0,0,5,0,FR
10897,39.99,15,0,0,0,0,0,99998,FR
11529,9.99,40,3,2,1,1,7,5.71,FR
11716,44.99,118,23,39,40,17,119,1.69,FR
11687,9.99,37,0,0,0,0,0,99998,FR
11703,10.99,0,16,12,15,4,47,0.02,FR
11710,24.99,20,9,4,10,9,32,2.5,FR
11704,34.99,82,5,13,0,2,20,4.1,FR
11724,29.99,4,0,0,0,0,0,99998,FR
11759,21.99,130,9,20,8,4,41,3.17,FR
11826,69.99,18,2,0,2,0,4,4.5,FR
11825,44.99,16,2,2,1,0,5,3.2,FR
11821,39.99,7,4,5,6,0,15,0.47,FR
11605,34.99,7,1,0,0,0,1,7,FR
11278,34.99,10,0,0,1,0,1,10,FR
10791,24.99,0,0,0,0,0,0,0,FR
11752,79.99,82,6,15,11,8,40,2.05,FR
11754,29.99,60,5,6,4,5,20,3,FR
11042,24.99,14,0,0,0,0,0,99998,FR
11850,24.99,22,2,2,2,2,8,4,FR
11419,19.99,43,0,0,0,0,0,99998,FR
10902,39.99,16,0,0,0,0,0,99998,FR
11370,14.99,8,7,3,0,1,11,0.73,FR
11705,16.99,12,2,3,0,1,6,2,FR
11765,4.99,3,0,0,1,1,2,1.5,FR
11796,5.99,13,0,0,0,1,1,13,FR
11797,5.99,13,0,0,0,0,0,99998,FR
11831,10.99,16,0,0,0,0,0,99998,FR
11832,10.99,30,0,0,0,0,0,99998,FR
10967,29.99,5,0,2,4,0,6,0.83,FR
11642,49.99,35,13,8,1,2,24,3.54,FR
11830,44.99,17,15,17,20,7,59,0.29,FR
18047,10.99,6,0,0,0,0,0,99998,FR
18046,10.99,5,0,0,0,0,0,99998,FR
18038,10.99,2,0,0,2,0,2,1,FR
18037,10.99,6,1,0,0,0,1,6,FR
18049,10.99,1,0,0,0,0,0,99998,FR
18040,10.99,4,0,0,0,0,0,99998,FR
18043,34.99,0,0,0,0,0,0,0,FR
18055,34.99,0,0,0,0,0,0,0,FR
11928,34.99,8,0,0,0,0,0,99998,FR
11887,24.99,13,0,0,0,0,0,99998,FR
11876,24.99,19,1,0,0,0,1,19,FR
11870,24.99,9,0,0,0,1,1,9,FR
11882,29.99,9,4,1,0,0,5,1.8,FR
11883,24.99,5,0,0,0,0,0,99998,FR
11962,29.99,2,2,2,4,1,9,0.22,FR
11963,34.99,4,0,0,0,0,0,99998,FR
18020,10.99,3,0,0,0,0,0,99998,FR
11766,19.99,4,0,0,0,0,0,99998,FR
11416,49.99,22,4,8,2,3,17,1.29,FR
11973,49.99,10,0,0,0,0,0,99998,FR
11452,39.99,14,2,0,1,0,3,4.67,FR
11961,44.99,8,4,1,2,2,9,0.89,FR
11893,29.99,8,0,0,0,0,0,99998,FR
11864,21.99,19,0,0,0,0,0,99998,FR
11858,24.99,19,0,0,1,0,1,19,FR
11019,34.99,10,1,0,0,0,1,10,FR
11972,24.99,27,3,4,1,2,10,2.7,FR
11798,34.99,1,1,1,0,0,2,3.5,FR
11801,39.99,5,0,0,1,0,1,5,FR
11807,49.99,6,2,1,0,0,3,4,FR
11978,34.99,5,1,2,0,0,3,1.67,FR
11904,34.99,10,0,0,0,1,1,10,FR
11923,34.99,5,0,1,0,0,1,5,FR
11924,39.99,9,0,0,0,0,0,99998,FR
11936,14.99,0,9,2,2,0,13,0,FR
11943,9.99,5,0,0,0,0,0,99998,FR
11925,14.99,0,0,0,1,1,2,0,FR
11908,10.99,2,0,0,0,0,0,99998,FR
11907,24.99,20,0,0,0,0,0,99998,FR
11980,44.99,7,0,0,0,0,0,99998,FR
11937,21.99,15,2,4,4,2,12,1.25,FR
11264,24.99,41,8,4,3,7,22,1.86,FR
12056,34.99,9,1,0,1,0,2,4.5,FR
11994,12.99,55,10,10,19,16,55,1,FR
12061,24.99,18,0,0,0,0,0,99998,FR
12062,29.99,19,1,1,0,0,2,9.5,FR
12065,14.99,39,0,0,0,0,0,99998,FR
12013,34.99,16,5,8,5,2,20,2.8,FR
11983,29.99,77,8,5,6,8,27,2.85,FR
11903,24.99,10,0,0,0,0,0,99998,FR
11764,5.99,5,0,0,0,0,0,99998,FR
12060,19.99,0,3,4,1,0,8,0,FR
12059,29.99,28,2,2,2,0,6,4.67,FR
12087,49.99,99,30,35,18,16,99,1.6,FR
12110,19.99,57,4,2,5,5,16,3.56,FR
12158,29.99,5,1,0,0,0,1,5,FR
12157,44.99,5,0,0,0,0,0,99998,FR
12150,34.99,10,0,0,0,0,0,99998,FR
12151,29.99,12,0,0,0,0,0,99998,FR
12067,34.99,58,1,0,0,2,3,19.33,FR
11956,24.99,26,0,0,0,0,0,99998,FR
12114,29.99,38,0,0,0,0,0,99998,FR
12120,29.99,71,2,0,2,1,5,14.2,FR
12129,4.99,14,0,0,0,0,0,99998,FR
12128,4.99,15,0,0,0,0,0,99998,FR
11824,34.99,39,0,0,0,0,0,99998,FR
11313,29.99,20,0,0,0,0,0,99998,FR
11307,29.99,20,0,0,0,0,0,99998,FR
11308,34.99,15,0,0,0,2,2,7.5,FR
11311,49.99,5,0,0,0,0,0,99998,FR
11317,64.99,9,2,1,0,0,3,3,FR
11312,64.99,18,0,0,0,0,0,99998,FR
12141,17.99,6,1,1,0,1,3,2,FR
12177,17.99,5,0,1,0,1,2,2.5,FR
12142,17.99,9,1,0,0,0,1,9,FR
11932,29.99,0,0,0,0,0,0,0,FR
11203,34.99,18,0,1,0,0,1,18,FR
12107,24.99,20,0,0,0,0,0,99998,FR
11310,39.99,12,0,0,0,0,0,99998,FR
11309,39.99,12,0,0,0,0,0,99998,FR
10891,8.99,19,1,2,0,5,8,2.38,IT
10887,6.99,7,2,3,3,1,9,0.78,IT
11077,18.99,20,3,16,0,0,19,1.05,IT
11145,15.99,11,4,5,5,4,18,0.61,IT
11017,22.99,103,15,26,7,8,56,1.84,IT
11018,24.99,0,0,0,0,0,0,0,IT
11002,39.99,3,0,3,2,0,5,0.6,IT
11287,29.99,33,2,5,7,2,16,2.06,IT
11265,26.99,139,22,31,28,8,89,1.67,IT
11258,24.99,77,20,10,30,9,69,1.12,IT
11387,9.99,52,7,8,6,5,26,2,IT
10844,19.99,17,8,0,1,1,10,1.7,IT
11168,16.99,184,30,25,22,12,89,2.23,IT
10914,14.99,9,2,2,6,1,11,0.82,IT
11167,19.99,126,16,24,20,9,69,1.83,IT
11091,16.99,30,5,1,3,3,12,2.5,IT
11284,19.99,44,3,4,0,4,11,4,IT
19998,8.99,87,3,6,11,9,29,3,IT
11411,19.99,25,7,6,9,4,26,0.96,IT
11402,12.99,269,38,40,18,8,104,2.94,IT
11417,44.99,1,0,0,0,0,0,99998,IT
11512,19.99,240,70,27,45,16,158,1.7,IT
11516,16.99,91,8,13,13,10,44,2.09,IT
11517,24.99,91,16,13,23,9,61,1.49,IT
11521,18.99,0,3,0,0,0,3,0,IT
11522,22.99,121,14,8,14,6,42,2.88,IT
18010,10.99,3,1,0,1,0,2,1.5,IT
11534,17.99,0,1,7,3,2,13,0,IT
11562,16.99,30,1,6,4,1,12,2.5,IT
11568,34.99,23,4,9,1,0,14,1.64,IT
11567,29.99,54,12,7,5,16,40,1.35,IT
11576,44.99,80,3,9,8,3,23,3.48,IT
11048,49.99,1,2,6,2,10,20,0.05,IT
11251,12.99,24,3,1,2,0,6,4,IT
11582,24.99,17,1,1,2,0,4,4.25,IT
10917,59.99,37,5,6,0,1,12,3.08,IT
11533,19.99,9,1,0,1,2,4,2.25,IT
11572,24.99,63,6,15,23,8,52,1.21,IT
11052,10.99,21,1,1,4,1,7,3,IT
11632,16.99,51,2,4,4,3,13,3.92,IT
11631,49.99,12,3,0,0,3,6,2,IT
11577,119.99,2,0,1,0,0,1,2,IT
11578,119.99,3,0,0,0,0,0,99998,IT
11019,14.99,10,0,4,4,1,9,1.11,IT
11628,29.99,23,3,3,2,2,10,2.3,IT
11635,22.99,59,6,2,10,7,25,2.36,IT
11621,26.99,0,0,0,0,0,0,0,IT
11613,59.99,42,2,1,1,0,4,10.5,IT
11651,39.99,0,5,0,0,0,5,0,IT
11546,22.99,155,42,15,23,7,87,2.03,IT
10442,11.99,148,10,6,10,14,40,3.7,IT
11643,17.99,72,9,1,5,2,17,4.24,IT
11538,14.99,42,5,3,3,2,13,3.23,IT
18026,10.99,4,0,0,1,0,1,4,IT
18025,10.99,2,1,0,1,0,2,1,IT
11444,13.99,8,0,0,0,0,0,99998,IT
11574,13.99,46,3,0,5,1,9,5.11,IT
11589,24.99,76,12,9,14,6,41,1.85,IT
11256,29.99,0,22,21,6,0,49,0,IT
11447,34.99,42,2,1,4,1,8,5.25,IT
11449,39.99,17,6,3,4,2,15,1.13,IT
11498,34.99,27,11,1,6,3,21,1.29,IT
11451,24.99,51,1,1,4,3,9,5.67,IT
11529,10.99,149,20,16,11,7,54,2.76,IT
11573,32.99,15,0,0,1,2,3,5,IT
11714,34.99,79,15,27,31,19,92,0.84,IT
11634,34.99,0,14,8,2,0,24,0,IT
10964,39.99,30,0,0,0,0,0,99998,IT
11597,39.99,22,0,0,1,1,2,11,IT
11687,9.99,87,0,1,11,3,15,5.8,IT
11705,17.99,8,3,1,1,1,6,1.33,IT
11697,19.99,63,11,5,6,3,25,2.52,IT
11629,29.99,302,40,65,77,38,220,1.37,IT
11693,15.99,91,16,16,14,10,56,1.63,IT
11703,14.99,199,19,16,11,5,51,3.92,IT
18037,10.99,0,0,0,0,1,1,0,IT
18040,9.99,3,0,1,1,0,2,1.5,IT
18038,9.99,0,0,0,2,0,2,0,IT
11724,11.99,16,1,1,1,0,3,5.33,IT
11757,16.99,90,72,28,33,22,155,0.66,IT
11770,17.99,14,3,4,1,1,9,1.56,IT
11817,52.99,28,8,4,13,1,26,1.08,IT
11820,44.99,0,5,6,10,3,24,0,IT
11457,59.99,67,17,21,13,10,61,1.1,IT
11292,34.99,35,1,5,1,0,7,5,IT
11845,24.99,13,0,0,0,0,0,99998,IT
11849,23.99,35,4,5,5,1,15,2.33,IT
11419,14.99,41,0,2,0,1,3,13.67,IT
11787,27.99,54,19,11,4,3,37,1.46,IT
11822,34.99,54,13,10,10,26,59,0.92,IT
10961,39.99,22,0,0,0,0,0,99998,IT
11371,19.99,26,0,0,0,0,0,99998,IT
11765,4.99,5,0,0,0,0,0,99998,IT
11764,5.99,2,0,0,0,1,1,2,IT
11796,5.99,4,0,0,0,0,0,99998,IT
11797,7.99,4,0,0,0,0,0,99998,IT
11831,10.99,75,2,0,1,2,5,15,IT
11832,10.99,10,0,1,1,1,3,3.33,IT
11655,49.99,9,0,0,2,0,2,4.5,IT
11766,19.99,11,0,0,0,0,0,99998,IT
11803,24.99,9,0,0,2,0,2,4.5,IT
11977,24.99,18,0,0,0,0,0,99998,IT
11809,29.99,16,0,0,0,0,0,99998,IT
11981,29.99,14,1,0,0,0,1,14,IT
11842,13.99,98,33,44,37,31,145,0.68,IT
11904,34.99,4,0,2,0,2,4,1,IT
11923,34.99,8,0,1,0,0,1,8,IT
11924,39.99,7,0,0,0,0,0,99998,IT
11926,24.99,60,10,12,11,8,41,1.46,IT
11943,9.99,13,0,1,0,0,1,13,IT
11907,24.99,5,0,0,0,1,1,5,IT
11925,5.99,0,1,2,0,0,3,0,IT
11908,12.99,4,0,0,0,0,0,99998,IT
11937,22.99,76,6,1,0,3,10,7.6,IT
11291,34.99,16,2,7,1,3,13,1.23,IT
11994,13.99,182,11,10,24,17,62,2.94,IT
11618,29.99,4,0,0,0,0,0,99998,IT
11983,29.99,192,21,17,31,12,81,2.43,IT
12013,34.99,41,3,2,5,5,15,2.73,IT
11903,10.99,35,9,8,17,2,36,0.97,IT
12060,16.99,5,2,1,0,1,4,1.25,IT
12068,34.99,59,12,6,13,8,39,1.54,IT
12075,34.99,79,17,10,5,3,35,2.26,IT
12064,19.99,60,9,5,12,9,35,1.71,IT
11955,16.99,42,8,3,5,3,19,2.21,IT
12116,29.99,70,7,13,13,9,42,1.67,IT
12121,24.99,10,1,2,2,0,5,2,IT
12128,5.99,5,0,0,0,0,0,99998,IT
12129,5.99,4,0,0,0,0,0,99998,IT
12142,14.99,5,2,1,1,4,8,0.63,IT
12141,14.99,34,5,0,4,2,11,3.09,IT
12177,14.99,35,4,4,0,1,9,4,IT
11276,4499,0,0,0,0,0,0,0,JP
11204,4999,9,0,6,0,1,7,1.29,JP
11280,4999,10,0,0,0,0,0,99998,JP
11281,3999,0,0,0,0,0,0,0,JP
10917,6499,18,8,2,0,0,10,1.8,JP
10789,2999,15,2,5,3,2,12,1.25,JP
10793,3499,20,0,0,0,0,0,99998,JP
10840,3499,11,0,0,2,10,12,0.92,JP
11033,2999,13,0,0,0,6,6,2.17,JP
10960,2499,22,5,0,4,2,11,2,JP
11252,4499,20,0,1,3,3,7,2.86,JP
11002,4999,16,4,3,1,2,10,1.6,JP
11005,4499,0,6,3,3,3,15,0,JP
11417,4999,0,0,0,0,0,0,0,JP
11048,5499,5,1,0,0,0,1,5,JP
11341,6999,9,0,0,0,0,0,99998,JP
11364,5499,5,0,0,0,0,0,99998,JP
10900,4999,13,1,4,1,0,6,2.17,JP
11267,3499,40,13,7,0,0,20,2,JP
11261,3499,16,2,1,2,0,5,3.2,JP
11387,1199,45,1,5,5,1,12,3.75,JP
10844,2299,32,0,2,2,1,5,6.4,JP
11168,2499,39,6,7,4,2,19,2.05,JP
10914,2499,53,8,9,7,7,31,1.71,JP
11167,2999,63,9,11,5,4,29,2.17,JP
11091,2299,21,1,2,3,1,7,3,JP
11251,1499,57,8,6,8,5,27,2.11,JP
19998,749,233,38,32,41,39,150,1.59,JP
11411,2999,30,0,0,7,2,9,3.33,JP
11402,1499,39,2,5,4,4,15,2.6,JP
11422,4999,11,1,1,0,0,2,5.5,JP
18010,1499,201,0,344,186,81,611,0.33,JP
18020,1499,0,0,0,0,0,0,0,JP
11486,2999,2,3,1,1,0,5,0.4,JP
11445,3999,0,0,0,0,0,0,0,JP
11516,2499,31,0,0,6,2,8,3.88,JP
11521,2499,0,25,24,19,1,69,0,JP
11517,2999,64,14,8,8,6,36,1.81,JP
11522,2499,251,43,37,39,34,153,1.67,JP
11525,6999,37,9,2,8,9,28,1.32,JP
11528,7499,12,0,3,0,0,3,4,JP
10532,4999,3,2,1,0,1,4,0.75,JP
11479,2499,30,0,1,4,1,6,5.33,JP
11533,2999,20,3,6,0,0,9,2.22,JP
11534,2499,0,10,0,0,0,10,0,JP
11502,1999,11,0,0,0,0,0,99998,JP
11506,3999,12,3,0,0,0,3,4,JP
11348,5999,0,0,0,0,0,0,0,JP
11562,2999,25,3,2,2,0,7,3.57,JP
18026,1499,68,33,50,1,25,109,0.68,JP
18028,1499,315,120,44,54,48,266,1.3,JP
11567,3999,25,3,1,2,1,7,3.57,JP
18033,3499,42,7,4,4,1,16,2.63,JP
11577,17999,10,0,0,0,0,0,99998,JP
11578,13999,4,1,0,1,1,3,1.33,JP
11052,1499,13,0,0,3,1,4,3.75,JP
11583,7499,17,0,0,0,1,1,17,JP
11582,3499,29,0,1,4,4,9,3.22,JP
11605,3999,50,8,2,6,3,19,2.63,JP
11593,3999,73,4,2,0,1,7,10.43,JP
11566,3499,6,3,0,4,3,10,0.6,JP
11635,2999,77,10,10,14,5,39,1.97,JP
11626,4999,7,0,1,0,0,1,7,JP
11611,8499,2,1,1,0,0,2,1,JP
10442,1299,48,0,4,5,1,10,4.8,JP
11354,9499,18,5,7,1,0,13,1.38,JP
11615,9499,8,1,0,0,0,1,8,JP
11633,9999,0,0,1,4,0,5,0,JP
18025,1499,444,34,165,76,44,319,1.42,JP
11670,2499,18,0,3,0,2,5,3.6,JP
10887,999,33,3,3,0,3,9,3.89,JP
10891,799,25,6,1,1,0,8,3.13,JP
18038,1499,0,0,0,0,0,0,0,JP
18037,1499,187,71,17,46,13,147,1.44,JP
18040,1499,167,42,48,2,8,100,2,JP
11663,6999,9,0,2,0,1,3,3,JP
11665,2999,22,8,2,4,3,17,1.29,JP
11648,6999,8,0,0,0,0,0,99998,JP
11454,6499,10,0,1,0,1,2,5,JP
11673,4999,21,1,0,2,0,3,7,JP
11574,1499,35,2,0,0,1,3,12.33,JP
11607,3499,26,5,3,1,1,10,2.6,JP
11706,2999,21,0,6,5,4,15,1.47,JP
11581,4999,61,17,13,13,1,44,1.39,JP
11573,3999,22,1,6,6,4,17,1.29,JP
11637,6999,10,3,0,2,2,7,1.43,JP
18047,1499,0,0,0,0,0,0,0,JP
18046,1499,182,55,10,56,16,137,1.41,JP
11529,999,72,30,15,17,40,102,0.68,JP
18049,1499,0,0,0,0,0,0,0,JP
11508,2999,0,1,0,1,0,2,0,JP
11541,9999,12,0,0,0,0,0,99998,JP
11543,6999,20,0,1,2,0,3,6.67,JP
11694,4999,12,0,0,0,0,0,99998,JP
11696,2999,14,0,0,1,1,2,7,JP
11444,999,11,1,1,0,0,2,5.5,JP
11062,4999,3,0,0,0,0,0,99998,JP
11703,1799,0,18,18,17,5,58,0,JP
11749,2999,13,1,0,0,0,1,13,JP
11447,4499,33,10,5,5,2,22,1.5,JP
11449,4999,36,3,9,4,4,20,1.8,JP
18043,3999,0,0,0,0,0,0,0,JP
18055,3999,0,0,0,0,0,0,0,JP
11684,4499,20,3,3,3,0,9,2.22,JP
11680,4999,43,8,6,8,3,25,1.72,JP
11687,1199,47,3,3,1,2,9,5.22,JP
11724,1999,41,3,2,2,0,7,5.86,JP
11750,2499,18,1,5,1,4,11,1.64,JP
11726,3499,11,0,0,0,0,0,99998,JP
11729,3499,7,1,0,0,0,1,7,JP
11019,2499,19,1,0,0,0,1,19,JP
11145,2999,6,0,1,0,2,3,2,JP
11419,2499,3,0,1,0,0,1,3,JP
11738,2999,7,1,1,6,5,13,0.62,JP
11705,2499,20,7,1,3,0,11,1.91,JP
11797,499,9,0,0,2,0,2,4.5,JP
11776,1999,28,7,1,3,1,12,2.33,JP
11794,4499,0,0,0,0,0,0,0,JP
11689,4999,16,3,4,7,8,22,0.73,JP
11700,7999,6,1,0,1,0,2,3,JP
11832,1499,11,1,1,2,1,5,2.2,JP
11831,1499,22,0,0,0,0,0,99998,JP
11538,1999,17,1,3,4,0,8,2.13,JP
11369,1999,5,0,0,0,0,0,99998,JP
10905,5499,0,0,0,0,0,0,0,JP
11798,6499,6,1,0,2,0,3,2,JP
11810,6499,5,0,0,0,0,0,99998,JP
11660,7499,5,0,0,1,0,1,5,JP
11668,4499,9,1,0,0,0,1,9,JP
11804,6999,13,1,4,1,0,6,2.17,JP
11811,6999,13,1,4,0,1,6,2.17,JP
11829,2999,20,0,0,0,0,0,99998,JP
11753,3999,0,0,0,0,0,0,0,JP
11985,3499,42,5,5,10,3,23,1.83,JP
11986,2499,32,4,3,6,8,21,1.52,JP
11722,1999,29,9,2,6,3,20,1.45,JP
11958,2999,11,1,1,0,0,2,5.5,JP
11466,3199,20,3,4,3,3,13,1.54,JP
11990,2699,2,0,1,2,1,4,0.5,JP
11568,3499,45,6,3,4,1,14,3.21,JP
11993,5999,16,0,2,4,1,7,2.29,JP
11924,4999,11,2,1,3,2,8,1.38,JP
11923,4499,15,2,1,0,3,6,2.5,JP
11904,4499,27,2,1,1,0,4,6.75,JP
10971,4499,17,4,1,3,1,9,1.89,JP
11953,4999,15,0,2,1,1,4,3.75,JP
11907,3499,23,0,4,2,2,8,3,JP
11909,4999,38,3,8,0,0,11,3.45,JP
11937,2999,22,3,4,3,3,13,1.69,JP
11902,4999,5,0,0,1,1,2,2.5,JP
11679,2999,14,4,0,2,3,9,1.56,JP
11935,11999,4,0,0,0,0,0,99998,JP
11669,7499,10,0,0,0,0,0,99998,JP
11944,3999,41,4,10,4,1,19,2.21,JP
11950,4499,33,9,4,1,6,20,1.7,JP
11994,1699,156,0,28,28,18,74,2.12,JP
11618,4499,9,0,0,0,0,0,99998,JP
11911,4999,6,1,0,0,2,3,2,JP
11912,4999,1,0,0,0,1,1,1,JP
11914,5999,19,2,1,1,0,4,4.75,JP
11915,5999,14,1,2,0,0,3,4.67,JP
11947,3499,16,1,2,2,2,7,2.29,JP
11913,4999,10,0,0,0,0,0,99998,JP
11916,5999,7,0,0,0,0,0,99998,JP
12010,3999,20,1,3,2,0,6,3.33,JP
11908,1999,11,1,0,0,0,1,11,JP
11943,999,34,5,2,3,1,11,3.09,JP
11572,2699,100,6,18,19,8,51,1.96,JP
11634,2999,0,0,0,0,0,0,0,JP
11917,6999,4,0,0,0,0,0,99998,JP
11918,6999,3,0,0,0,0,0,99998,JP
11920,7499,2,0,0,0,1,1,2,JP
11921,7499,6,1,0,0,0,1,6,JP
11922,7499,5,0,0,0,0,0,99998,JP
11653,4999,16,0,2,0,0,2,8,JP
11967,8499,11,1,0,2,1,4,2.75,JP
11983,3499,22,3,3,4,1,11,2,JP
12013,3999,70,5,13,11,3,32,2.25,JP
11919,6999,4,0,0,0,0,0,99998,JP
12060,2299,8,0,3,1,3,7,1.14,JP
11903,1999,39,1,0,0,0,1,39,JP
12122,4499,10,0,0,0,0,0,99998,JP
12123,3999,11,1,1,3,2,7,1.57,JP
12124,3499,12,1,1,0,0,2,6,JP
11284,2499,61,7,6,13,8,34,1.79,JP
11764,499,43,5,8,9,3,25,1.72,JP
11765,499,46,5,8,4,5,22,2.09,JP
11988,9999,5,0,0,0,0,0,99998,JP
11987,9999,12,0,0,3,0,3,4,JP
11989,6999,11,0,1,0,0,1,11,JP
11976,6499,13,0,1,1,1,3,4.33,JP
12057,4499,53,9,8,9,4,30,1.77,JP
11834,6499,8,1,0,1,0,2,4,JP
11707,4499,9,0,0,0,0,0,99998,JP
11519,5499,6,0,0,0,0,0,99998,JP
11315,4499,7,0,1,1,1,3,2.33,JP
11314,4499,7,1,0,1,0,2,3.5,JP
11316,7999,4,0,0,0,0,0,99998,JP
12129,499,19,0,0,0,0,0,99998,JP
12128,449,20,0,0,0,0,0,99998,JP
12105,2999,20,0,0,0,0,0,99998,JP
11796,549,15,0,0,0,0,0,99998,JP
12003,2999,11,1,0,1,0,2,5.5,JP
12007,7999,3,0,0,0,0,0,99998,JP
12048,6999,2,0,0,0,0,0,99998,JP
12127,3499,4,0,0,0,0,0,99998,JP
11320,6499,6,0,0,0,0,0,99998,JP
11321,4999,13,1,0,2,0,3,4.33,JP
11303,16999,0,0,0,0,0,0,0,JP
11305,16999,6,0,0,0,0,0,99998,JP
12198,6499,6,0,0,0,0,0,99998,JP
11304,16999,6,0,0,0,0,0,99998,JP
11839,4999,8,0,0,0,0,0,99998,JP
11077,2999,11,1,2,2,1,6,2,JP
12206,6999,3,0,0,0,0,0,99998,JP
11327,4999,6,0,0,0,0,0,99998,JP
11325,3999,3,0,0,2,0,2,1.5,JP
12196,4999,6,0,0,0,0,0,99998,JP
12142,1999,18,0,0,0,1,1,18,JP
12177,1999,18,0,0,0,1,1,18,JP
12141,1999,20,0,0,0,0,0,99998,JP
12204,6999,6,0,0,0,0,0,99998,JP
12235,4999,10,0,0,0,0,0,99998,JP
12215,3999,5,0,0,0,0,0,99998,JP
12217,3499,5,0,0,0,0,0,99998,JP
10716,699,19,0,0,0,0,0,99998,JP
12139,799,20,0,0,0,0,0,99998,JP
12140,999,20,0,0,0,0,0,99998,JP
12166,2999,19,0,1,0,0,1,19,JP
18067,2499,0,0,0,30,1,31,0,JP
18068,2499,13,0,0,7,9,16,0.81,JP
18069,2499,0,0,0,16,12,28,0.04,JP
10103,12999,0,0,0,0,0,0,0,JP
12174,0,0,0,0,0,0,0,0,JP
12174,0,0,0,0,0,0,0,0,JP
12176,0,0,0,0,0,0,0,0,JP
12172,0,0,0,0,0,0,0,0,JP
11298,0,0,0,0,0,0,0,0,JP
11299,0,0,0,0,0,0,0,0,JP
10887,6.99,115,13,18,16,8,55,2.09,UK
10891,4.99,66,4,10,11,6,31,2.13,UK
11077,14.99,209,40,36,39,39,154,1.36,UK
11145,14.99,56,11,7,11,8,37,1.51,UK
10985,16.99,93,9,8,10,5,32,2.91,UK
10857,16.99,134,7,6,1,6,20,6.7,UK
10839,19.99,180,16,97,3,1,117,2.82,UK
10855,15.99,110,61,60,71,44,236,0.48,UK
11395,19.99,125,1,4,2,2,9,13.89,UK
11365,24.99,79,26,3,1,1,31,2.55,UK
10966,24.99,10,6,3,4,0,13,0.77,UK
10904,19.99,71,2,4,3,0,9,7.89,UK
11266,22.99,336,49,38,31,26,144,2.77,UK
11260,22.99,130,11,12,11,5,39,3.33,UK
11168,14.99,152,19,2,2,0,23,8.35,UK
11167,19.99,224,45,35,31,18,129,1.87,UK
11387,9.99,53,0,4,4,4,12,4.42,UK
10844,16.99,38,0,0,0,0,0,99998,UK
10914,17.99,16,1,2,0,0,3,5.33,UK
11284,19.99,70,3,3,1,0,7,10,UK
11091,14.99,105,3,5,3,3,14,7.5,UK
11251,11.99,119,18,41,8,4,71,1.68,UK
19998,4.99,71,5,2,2,0,9,7.89,UK
11411,19.99,68,7,4,5,2,18,3.78,UK
11427,39.99,70,3,18,11,1,33,2.12,UK
18010,9.99,2,2,0,1,1,4,0.5,UK
11516,14.99,58,6,6,12,2,26,2.27,UK
11517,19.99,91,4,5,4,0,13,7,UK
11522,19.99,193,16,16,25,7,64,3.02,UK
11485,16.99,511,75,46,22,28,171,3.35,UK
11521,16.99,45,3,3,0,0,6,7.5,UK
11530,49.99,50,1,5,0,0,6,8.33,UK
11524,37.99,254,28,4,6,2,40,6.35,UK
11533,19.99,23,0,0,0,0,0,99998,UK
11534,16.99,32,1,0,3,0,4,8,UK
11562,19.99,33,2,0,1,4,7,4.71,UK
11568,29.99,88,18,12,7,18,55,1.6,UK
11567,26.99,80,1,6,1,3,11,7.27,UK
18028,9.99,7,2,0,0,0,2,3.5,UK
11578,89.99,6,0,1,0,0,1,6,UK
11582,24.99,27,0,1,1,0,2,13.5,UK
11599,24.99,81,2,3,19,12,36,2.25,UK
11505,19.99,67,12,3,7,4,26,2.58,UK
11572,29.99,89,16,15,11,6,48,1.85,UK
11019,19.99,34,1,0,0,0,1,34,UK
11640,24.99,1,12,3,4,4,23,0.04,UK
11473,19.99,258,38,10,37,29,114,2.26,UK
11501,14.99,124,24,0,0,0,24,5.17,UK
11635,19.99,66,2,4,7,3,16,4.13,UK
11616,44.99,63,3,8,3,3,17,3.71,UK
11538,11.99,49,7,7,7,5,26,1.88,UK
10442,11.99,78,7,10,16,7,40,1.95,UK
11625,24.99,57,1,0,3,1,5,11.4,UK
11052,7.99,80,7,8,9,10,34,2.35,UK
18026,9.99,7,0,0,1,0,1,7,UK
11429,44.99,187,27,20,26,13,86,2.28,UK
18025,9.99,6,1,0,0,0,1,6,UK
11444,9.99,16,0,0,0,0,0,99998,UK
11574,14.99,19,1,1,1,0,3,6.33,UK
11591,39.99,139,34,24,18,17,93,1.6,UK
11667,16.99,248,22,12,5,0,39,6.36,UK
11674,44.99,251,41,52,43,13,149,2.1,UK
11447,34.99,28,4,1,0,1,6,4.67,UK
11455,34.99,85,17,13,12,8,50,1.7,UK
11449,39.99,12,2,1,1,0,4,3,UK
11692,13.99,159,2,2,8,3,15,10.6,UK
11529,9.99,109,12,6,1,0,19,5.74,UK
11579,19.99,150,9,9,3,4,25,6,UK
11489,44.99,9,0,1,0,0,1,9,UK
11573,34.99,20,1,2,0,0,3,6.67,UK
11570,19.99,37,2,3,0,0,5,7.4,UK
11527,39.99,33,3,4,1,4,12,2.75,UK
11705,16.99,15,1,2,3,2,8,1.88,UK
11442,59.99,25,21,20,36,8,85,0.3,UK
11609,19.99,170,25,26,23,18,92,1.9,UK
11634,29.99,0,18,6,4,0,28,0,UK
11691,34.99,105,8,12,9,13,42,2.5,UK
11768,8.99,245,48,53,60,57,218,1.1,UK
18038,9.99,0,0,0,0,0,0,0,UK
18037,9.99,3,0,1,0,0,1,3,UK
18040,9.99,4,0,0,0,0,0,99998,UK
11368,19.99,38,0,0,0,0,0,99998,UK
10899,31.99,7,1,0,0,0,1,7,UK
11687,7.99,69,3,3,1,2,9,7.67,UK
11698,16.99,126,13,6,8,8,35,3.6,UK
11703,12.99,39,18,29,26,19,92,0.42,UK
18043,31.99,1,0,1,0,0,1,1,UK
11686,29.99,88,10,23,11,4,48,1.83,UK
18055,31.99,0,0,0,0,0,0,0,UK
18047,9.99,0,0,0,1,0,1,0,UK
18046,9.99,6,1,0,0,0,1,6,UK
11724,14.99,31,2,0,0,1,3,10.33,UK
11730,19.99,65,6,4,3,3,16,4.06,UK
11733,11.99,38,41,76,53,53,223,0.21,UK
11742,14.99,152,2,0,4,1,7,21.71,UK
11745,19.99,0,0,0,0,0,0,0,UK
11419,11.99,63,0,0,0,0,0,99998,UK
11044,9.99,19,0,1,4,1,6,3.17,UK
11848,9.99,12,0,0,0,3,3,4,UK
11875,19.99,4,1,0,1,0,2,2,UK
11886,24.99,5,0,1,1,0,2,2.5,UK
11897,19.99,5,0,1,0,0,1,5,UK
11279,34.99,9,0,1,1,1,3,3,UK
11881,14.99,20,0,1,0,0,1,20,UK
11764,3.99,81,0,0,0,0,0,99998,UK
11765,2.99,73,0,0,0,0,0,99998,UK
11796,2.99,57,0,0,0,1,1,57,UK
11797,4.99,40,1,1,0,0,2,20,UK
11341,59.99,5,0,1,0,0,1,5,UK
11577,139.99,4,0,0,0,0,0,99998,UK
11831,9.99,60,7,4,9,2,22,2.73,UK
11654,29.99,81,13,8,3,0,24,3.38,UK
11832,8.99,23,0,3,1,1,5,4.6,UK
11874,19.99,16,1,0,1,1,3,5.33,UK
11862,19.99,16,0,0,1,0,1,16,UK
11868,19.99,7,0,1,0,0,1,7,UK
11418,32.99,129,2,0,1,1,4,32.25,UK
11884,29.99,6,0,0,0,0,0,99998,UK
11802,24.99,105,14,9,14,4,41,2.56,UK
11808,34.99,90,7,12,8,8,35,2.57,UK
11766,14.99,14,1,1,1,1,4,3.5,UK
11662,49.99,202,19,16,9,7,51,3.96,UK
11727,19.99,111,19,9,13,13,54,2.43,UK
11739,19.99,80,4,10,6,2,22,3.64,UK
11840,11.99,50,5,10,11,21,47,1.06,UK
11959,19.99,142,13,15,7,7,42,3.38,UK
11402,11.99,110,25,27,23,10,85,1.89,UK
11838,16.99,128,5,6,1,2,14,9.14,UK
11904,34.99,12,0,2,2,3,7,1.71,UK
11924,39.99,25,0,0,0,0,0,99998,UK
11923,34.99,25,0,0,1,0,1,25,UK
11943,4.99,19,5,3,0,0,8,2.38,UK
11760,24.99,0,1,1,1,5,8,0,UK
12000,39.99,0,1,0,0,0,1,0,UK
11998,19.99,4,0,0,0,0,0,99998,UK
11999,24.99,15,0,0,0,0,0,99998,UK
11910,39.99,135,28,19,28,20,95,1.66,UK
11954,39.99,155,25,36,41,25,127,1.54,UK
11908,7.99,7,0,1,0,0,1,7,UK
11925,11.99,17,0,1,0,0,1,17,UK
11907,22.99,16,1,0,0,0,1,16,UK
11937,19.99,107,0,2,11,7,20,5.35,UK
11002,49.99,4,2,0,0,0,2,2,UK
11761,34.99,7,0,0,0,0,0,99998,UK
12055,24.99,17,0,3,3,1,7,2.43,UK
11901,29.99,78,1,10,8,2,21,3.71,UK
11951,26.99,109,10,20,17,10,57,1.91,UK
11657,29.99,121,2,4,2,2,10,12.1,UK
11970,19.99,77,6,4,10,3,23,3.35,UK
11994,11.99,121,18,35,8,12,73,1.66,UK
11948,24.99,122,6,13,12,11,42,2.9,UK
11971,34.99,80,9,6,14,5,34,2.35,UK
11598,39.99,72,9,5,6,5,25,2.88,UK
12063,29.99,11,1,2,0,1,4,2.75,UK
11944,29.99,8,0,0,0,0,0,99998,UK
12013,29.99,79,2,4,3,3,12,6.58,UK
11903,19.99,36,2,1,0,1,4,9,UK
11983,24.99,129,28,15,14,4,61,2.11,UK
12060,16.99,16,2,1,2,1,6,2.67,UK
12051,29.99,82,3,5,5,2,15,5.47,UK
11644,24.99,49,7,6,2,6,21,2.33,UK
12012,22.99,101,14,19,17,4,54,1.87,UK
12159,29.99,0,0,0,0,0,0,0,UK
12152,19.99,1,1,1,0,1,3,0.33,UK
11827,22.99,79,0,0,0,0,0,99998,UK
11945,19.99,81,11,3,5,3,22,4.59,UK
12129,3.99,17,2,0,0,0,2,8.5,UK
11205,29.99,23,3,4,3,0,10,2.3,UK
12128,3.99,19,0,0,0,0,0,99998,UK
12141,11.99,25,1,2,4,2,9,2.78,UK
12142,11.99,22,2,5,10,5,22,1,UK
12177,11.99,51,3,3,3,6,15,3.4,UK
12106,24.99,70,7,3,6,12,28,2.5,UK
12167,19.99,80,0,0,0,0,0,99998,UK
10891,6.99,398,0,2,28,4,34,11.71,USA
10887,7.99,306,0,1,3,0,4,76.75,USA
11077,19.99,40,0,0,0,0,0,99998,USA
11145,17.99,20,0,0,0,1,1,20,USA
11204,39.99,76,6,1,1,0,8,9.63,USA
11280,39.99,61,8,13,8,6,35,1.74,USA
10789,19.99,87,31,36,11,6,84,2.06,USA
10793,19.99,22,2,4,1,0,7,3.14,USA
10840,24.99,275,1,10,0,0,11,25,USA
11033,24.99,113,1,1,1,0,3,37.67,USA
10960,19.99,153,39,35,21,9,104,2.14,USA
11252,39.99,201,2,2,2,4,10,20.1,USA
11002,49.99,28,8,0,0,0,8,3.5,USA
11005,49.99,0,19,1,0,0,20,0,USA
11417,59.99,0,0,0,0,0,0,0,USA
11341,59.99,53,4,6,0,1,11,4.82,USA
11364,39.99,50,6,0,4,0,10,5,USA
10532,39.99,61,1,3,3,1,8,7.63,USA
10699,24.99,4,12,0,1,0,13,0.31,USA
11369,24.99,36,0,1,1,0,2,18,USA
10900,32.99,48,4,4,2,2,12,4.83,USA
10905,29.99,14,1,1,1,0,3,4.67,USA
11267,22.99,138,9,4,0,0,13,10.69,USA
11261,21.99,57,11,8,0,4,23,2.48,USA
11387,7.99,242,69,49,52,15,185,1.92,USA
10844,14.99,236,6,15,10,7,38,6.21,USA
11168,16.99,855,222,232,204,81,739,1.33,USA
10914,11.99,115,26,13,29,14,82,1.63,USA
11167,19.99,1381,262,327,310,115,1014,1.44,USA
11411,16.99,53,13,21,12,4,50,1.64,USA
11091,11.99,107,36,19,17,2,74,1.47,USA
11251,9.99,260,52,41,17,1,111,2.87,USA
11284,19.99,310,1,11,1,0,13,23.85,USA
19998,6.99,387,47,39,46,23,155,2.63,USA
11402,9.99,1235,77,319,89,79,564,2.37,USA
11422,49.99,28,1,2,18,1,22,1.27,USA
11445,59.99,0,0,0,0,0,0,0,USA
11516,19.99,170,28,36,25,6,95,2.05,USA
11517,24.99,206,53,61,40,18,172,1.32,USA
11522,19.99,276,67,56,48,13,184,1.68,USA
11525,44.99,420,8,11,13,6,38,11.05,USA
11506,29.99,87,15,10,5,3,33,2.64,USA
11534,17.99,30,12,14,4,3,33,0.97,USA
11567,29.99,240,29,43,41,17,130,1.95,USA
11568,24.99,342,71,88,78,30,267,1.36,USA
18028,9.99,27,20,15,15,7,57,1.35,USA
18033,29.99,16,3,2,11,2,18,0.89,USA
11578,119.99,23,4,6,5,1,16,1.44,USA
11577,149.99,25,4,1,1,1,7,3.57,USA
11352,29.99,15,4,4,1,0,9,1.67,USA
11566,24.99,218,136,208,184,65,593,0.39,USA
11582,19.99,62,10,12,16,9,47,1.32,USA
11593,24.99,59,3,5,4,2,14,4.21,USA
11571,29.99,0,0,1,0,0,1,0,USA
11605,24.99,140,8,9,18,5,40,3.5,USA
11623,39.99,4,2,1,1,0,4,1,USA
11635,14.99,204,42,46,32,13,133,1.84,USA
11615,69.99,128,23,15,14,4,56,2.29,USA
10442,9.99,216,75,68,59,33,235,1.02,USA
11611,49.99,285,0,1,1,1,3,95,USA
11626,29.99,115,0,11,36,10,57,2.02,USA
11538,9.99,65,6,8,14,4,32,2.03,USA
11019,17.99,100,15,16,27,16,74,1.35,USA
11052,8.99,389,1,0,0,0,1,389,USA
11633,79.99,0,96,47,1,2,146,0,USA
18026,9.99,8,22,25,29,4,80,0.12,USA
11648,44.99,110,4,6,5,0,15,7.4,USA
18025,9.99,64,8,9,6,1,24,2.75,USA
11444,7.99,46,2,0,5,0,7,6.57,USA
11574,9.99,67,5,6,2,0,13,5.15,USA
11670,19.99,99,24,23,16,11,74,1.34,USA
11447,39.99,210,27,11,23,21,82,2.84,USA
11449,39.99,177,59,22,25,9,115,1.79,USA
11665,19.99,116,11,6,15,10,42,3.24,USA
11663,44.99,51,6,6,9,7,28,1.82,USA
11668,19.99,34,0,1,0,0,1,34,USA
11689,39.99,87,45,59,52,26,182,0.5,USA
11529,6.99,1543,489,344,147,44,1024,1.99,USA
11508,13.99,178,0,0,0,0,0,99998,USA
11573,29.99,28,1,4,1,8,14,2,USA
11048,49.99,45,0,0,0,0,0,99998,USA
11694,24.99,32,4,13,1,1,19,1.68,USA
11541,29.99,75,11,20,12,5,48,1.56,USA
11607,24.99,138,20,28,12,24,84,1.65,USA
18040,9.99,35,2,5,3,0,10,3.5,USA
18037,9.99,20,20,20,14,8,62,1.13,USA
18038,9.99,0,0,0,0,0,0,0,USA
11543,34.99,104,12,5,0,0,17,6.12,USA
11687,7.99,258,3,0,5,0,8,32.25,USA
11507,14.99,0,4,0,0,0,4,0,USA
11696,17.99,45,7,6,4,3,20,2.25,USA
10788,19.99,18,0,2,0,0,2,9,USA
11510,19.99,25,2,0,0,0,2,12.5,USA
11595,16.99,37,0,2,0,0,2,18.5,USA
11575,44.99,28,3,6,3,0,12,2.33,USA
11614,69.99,12,0,2,0,0,2,6,USA
11590,49.99,12,1,0,2,1,4,3,USA
11636,49.99,8,0,0,2,2,4,2,USA
11263,21.99,36,1,0,1,1,3,12,USA
11182,19.99,29,0,0,1,0,1,29,USA
18047,9.99,0,1,0,0,0,1,0,USA
18046,9.99,53,3,12,9,5,29,1.86,USA
18049,9.99,0,0,0,0,0,0,0,USA
11062,49.99,24,8,5,1,2,16,1.5,USA
11703,9.99,72,44,72,53,6,175,0.45,USA
11350,49.99,61,11,5,12,9,37,1.65,USA
18043,34.99,0,0,0,0,0,0,0,USA
18055,34.99,0,0,0,0,0,0,0,USA
11680,34.99,56,6,3,3,1,13,4.31,USA
11684,29.99,191,32,32,37,25,126,1.55,USA
11458,24.99,35,5,45,5,7,62,1.74,USA
11751,79.99,35,11,4,9,1,25,1.4,USA
11712,29.99,12,1,0,0,0,1,12,USA
11724,11.99,50,4,7,13,10,34,1.53,USA
11562,19.99,29,2,3,8,0,13,2.31,USA
11354,69.99,1324,18,51,152,71,292,4.14,USA
18010,9.99,74,14,19,18,1,52,1.42,USA
11771,15.99,10,0,2,0,0,2,5,USA
11748,19.99,9,0,0,0,0,0,99998,USA
11709,19.99,38,0,0,1,0,1,38,USA
11596,44.99,15,0,0,0,0,0,99998,USA
11711,24.99,32,3,1,0,1,5,6.4,USA
11715,34.99,19,0,0,2,0,2,9.5,USA
11288,24.99,40,0,0,0,0,0,99998,USA
11798,29.99,190,0,1,2,0,3,63.33,USA
11804,49.99,104,0,0,0,0,0,99998,USA
11810,29.99,54,0,0,0,0,0,99998,USA
11726,19.99,118,12,12,23,8,55,2.16,USA
11729,24.99,158,44,73,14,15,146,1.43,USA
10917,59.99,108,0,2,0,0,2,54,USA
11705,17.99,201,4,3,4,0,11,18.27,USA
11738,19.99,109,35,35,19,25,114,1.38,USA
11776,17.99,105,1,6,1,0,8,13.13,USA
11797,5.99,68,0,0,0,0,0,99998,USA
11791,22.99,0,0,0,0,0,0,0,USA
11765,4.99,157,0,0,0,0,0,99998,USA
11796,4.99,68,0,0,0,1,1,68,USA
11764,4.99,84,2,2,1,1,6,14.17,USA
11372,19.99,18,0,0,1,0,1,18,USA
11290,29.99,5,2,0,0,0,2,2.5,USA
10792,19.99,0,0,0,0,0,0,0,USA
11700,39.99,32,9,6,13,7,35,0.91,USA
11832,7.99,101,11,11,34,6,62,1.63,USA
11831,9.99,62,13,4,7,8,32,1.94,USA
11533,19.99,115,5,5,5,3,18,6.39,USA
11891,24.99,20,0,0,0,1,1,20,USA
11967,54.99,92,18,19,26,12,75,1.23,USA
11660,49.99,149,41,45,25,15,126,1.8,USA
11871,19.99,61,1,2,0,0,3,20.33,USA
11877,19.99,30,0,2,1,1,4,7.5,USA
11818,44.99,5,0,0,0,0,0,99998,USA
11630,49.99,26,4,0,0,0,4,6.5,USA
11545,17.99,7,4,19,2,0,25,1.08,USA
11851,19.99,18,0,1,0,0,1,18,USA
11521,17.99,114,5,3,0,0,8,14.38,USA
11766,19.99,102,12,20,12,10,54,1.89,USA
11829,22.99,139,14,41,3,1,59,2.37,USA
10898,24.99,1,0,0,0,0,0,99998,USA
10903,14.99,0,0,0,0,0,0,0,USA
11846,21.99,0,0,0,0,0,0,0,USA
11839,34.99,28,3,1,4,0,8,3.5,USA
11958,19.99,88,16,13,34,7,70,1.34,USA
11943,6.99,66,2,4,3,0,9,7.33,USA
11993,49.99,68,3,9,5,0,17,4,USA
11800,29.99,4,1,0,1,0,2,2,USA
11979,29.99,2,0,0,1,0,1,2,USA
11806,44.99,11,0,0,0,1,1,11,USA
11982,44.99,1,0,0,0,0,0,99998,USA
11634,29.99,0,88,56,1,2,147,0,USA
11904,39.99,43,4,2,2,1,9,4.78,USA
11923,29.99,47,3,5,9,5,22,2.14,USA
11924,29.99,70,6,13,16,4,39,1.79,USA
11572,29.99,93,44,34,49,15,142,0.99,USA
11528,44.99,150,27,25,37,10,99,1.58,USA
11781,14.99,2,0,0,0,0,0,99998,USA
11908,8.99,20,13,1,1,0,15,1.33,USA
11925,9.99,15,0,1,2,1,4,3.75,USA
11811,49.99,82,0,0,0,0,0,99998,USA
11874,19.99,12,0,0,1,0,1,12,USA
11880,14.99,0,0,0,0,0,0,0,USA
11953,39.99,238,46,60,77,23,206,1.3,USA
11909,39.99,132,29,49,40,20,138,1.54,USA
11902,24.99,58,3,12,13,6,34,1.71,USA
11679,22.99,107,28,31,23,6,88,1.84,USA
11419,19.99,71,10,5,17,0,32,2.22,USA
12007,69.99,6,0,0,0,0,0,99998,USA
12008,44.99,8,0,0,0,0,0,99998,USA
12003,9.99,2,0,0,0,0,0,99998,USA
12009,29.99,21,0,0,0,0,0,99998,USA
11907,14.99,22,4,3,2,0,9,2.67,USA
11937,24.99,101,7,12,12,25,56,1.82,USA
11502,19.99,31,2,2,0,1,5,6.2,USA
11602,39.99,6,0,1,0,0,1,6,USA
12027,39.99,6,0,0,0,0,0,99998,USA
12026,39.99,6,0,1,0,0,1,6,USA
12048,39.99,6,1,0,0,0,1,6,USA
12015,24.99,1,0,0,0,0,0,99998,USA
12018,34.99,6,1,0,0,0,1,6,USA
12014,24.99,20,1,0,0,0,1,20,USA
12017,34.99,0,0,0,0,0,0,0,USA
12016,34.99,27,0,1,2,1,4,6.75,USA
12049,24.99,7,0,0,0,0,0,99998,USA
11935,29.99,32,2,2,2,0,6,5.33,USA
11551,14.99,10,0,0,0,0,0,99998,USA
11552,14.99,7,0,2,0,0,2,3.5,USA
12033,29.99,22,0,0,0,0,0,99998,USA
12030,24.99,26,0,0,0,0,0,99998,USA
12044,14.99,6,3,7,6,2,18,0.33,USA
12041,14.99,3,3,2,0,0,5,0.6,USA
12042,14.99,11,0,0,0,0,0,99998,USA
12046,14.99,32,4,2,6,1,13,2.46,USA
12043,14.99,47,2,0,0,0,2,23.5,USA
12054,19.99,0,0,0,0,0,0,0,USA
11905,24.99,25,1,1,1,0,3,8.33,USA
11906,29.99,0,1,1,0,0,2,0,USA
11669,49.99,56,4,7,4,4,19,2.95,USA
11983,29.99,139,21,26,39,11,97,1.46,USA
11994,9.99,382,99,156,87,40,382,1.45,USA
11618,29.99,65,19,6,7,3,35,1.86,USA
11950,39.99,65,12,13,11,6,42,1.55,USA
11944,19.99,80,14,6,9,5,34,2.35,USA
12058,19.99,25,0,0,0,0,0,99998,USA
11914,29.99,34,1,2,0,0,3,11.33,USA
11920,49.99,20,1,0,0,0,1,20,USA
11911,24.99,21,1,1,4,0,6,3.67,USA
11917,39.99,7,2,4,0,0,6,2,USA
11947,29.99,67,18,12,15,11,56,1.96,USA
11916,29.99,29,0,0,3,2,5,5.8,USA
11912,24.99,20,3,11,7,2,23,0.87,USA
11913,24.99,18,6,5,2,3,16,1.13,USA
11915,29.99,34,1,1,0,0,2,17,USA
11043,14.99,12,0,1,0,1,2,6,USA
11653,29.99,33,2,7,5,1,15,2.2,USA
11918,39.99,17,3,2,4,1,10,1.9,USA
11919,39.99,8,2,4,4,0,10,0.8,USA
11921,49.99,22,1,1,0,0,2,11,USA
11922,49.99,24,0,1,2,0,3,8,USA
12010,29.99,210,44,37,16,7,104,2.36,USA
12013,29.99,107,21,14,11,5,51,2.1,USA
11903,6.99,57,8,8,16,5,37,1.54,USA
12060,16.99,4,16,13,11,2,42,1.07,USA
11987,29.99,21,0,2,1,1,4,5.25,USA
11988,29.99,14,3,2,5,2,12,1.17,USA
11989,24.99,32,1,6,11,2,20,2.6,USA
12127,9.99,10,2,0,0,0,2,5,USA
12005,9.99,6,0,1,0,0,1,6,USA
12124,14.99,4,0,0,1,0,1,4,USA
12122,29.99,5,0,0,4,0,4,1.25,USA
12123,19.99,0,1,5,4,0,10,0,USA
12136,19.99,11,1,0,3,0,4,2.75,USA
11957,14.99,19,0,0,0,0,0,99998,USA
11289,34.99,6,0,0,1,0,1,6,USA
12143,29.99,6,0,0,0,0,0,99998,USA
12144,24.99,9,0,2,1,0,3,3,USA
12145,74.99,9,1,0,0,0,1,9,USA
12146,29.99,4,0,1,0,0,1,4,USA
12147,19.99,9,0,0,0,0,0,99998,USA
12148,29.99,17,1,0,0,0,1,17,USA
11995,74.99,6,0,0,0,0,0,99998,USA
12159,29.99,1,0,2,0,0,2,0.5,USA
12152,29.99,2,1,0,0,0,1,2,USA
12171,29.99,10,0,0,0,0,0,99998,USA
12076,24.99,19,0,0,0,0,0,99998,USA
11976,14.99,69,5,6,6,7,24,2.92,USA
12081,19.99,21,7,10,4,6,27,0.93,USA
11519,39.99,58,1,1,1,0,3,19.33,USA
11885,19.99,19,0,0,0,0,0,99998,USA
11707,29.99,60,3,4,5,2,14,4.29,USA
11834,39.99,37,0,3,2,3,8,4.63,USA
11673,34.99,322,18,101,39,8,166,2.85,USA
11303,99.99,138,2,2,3,0,7,19.71,USA
11304,99.99,378,4,2,6,3,15,25.2,USA
11305,99.99,210,7,4,8,0,19,11.05,USA
12105,24.99,90,23,37,27,17,104,1.2,USA
12128,4.99,89,0,0,0,0,0,99998,USA
12129,4.99,98,1,0,0,0,1,98,USA
11819,34.99,4,1,1,2,0,4,1,USA
12024,39.99,6,0,0,0,0,0,99998,USA
11323,69.99,6,0,0,0,0,0,99998,USA
12214,69.99,6,0,0,0,0,0,99998,USA
11314,29.99,3,2,1,0,0,3,1,USA
11315,34.99,6,0,1,1,0,2,3,USA
11316,69.99,6,0,0,0,0,0,99998,USA
12040,9.99,13,0,2,0,0,2,6.5,USA
11862,19.99,0,0,1,0,0,1,0,USA
12038,9.99,8,0,1,0,0,1,11,USA
12031,24.99,18,0,0,0,0,0,99998,USA
12032,29.99,6,0,0,0,0,0,99998,USA
12028,24.99,18,0,0,0,0,0,99998,USA
12029,29.99,6,0,0,0,0,0,99998,USA
12023,39.99,12,0,0,0,0,0,99998,USA
12025,39.99,6,0,0,0,0,0,99998,USA
12034,44.99,18,0,0,0,0,0,99998,USA
12036,44.99,18,0,0,0,0,0,99998,USA
12035,44.99,6,0,0,0,0,0,99998,USA
12141,9.99,147,15,20,14,14,63,2.43,USA
12142,9.99,87,16,29,21,18,84,1.12,USA
12177,9.99,155,17,25,22,14,78,1.99,USA
12202,44.99,12,0,0,0,0,0,99998,USA
12203,44.99,12,0,0,0,0,0,99998,USA
11320,39.99,5,1,0,0,0,1,5,USA
12198,39.99,6,0,0,0,0,0,99998,USA
11322,19.99,0,0,0,0,0,0,0,USA
11324,19.99,0,0,0,0,0,0,0,USA
11325,14.99,11,1,2,0,0,3,3.67,USA
11326,29.99,0,0,0,0,0,0,0,USA
12195,34.99,0,0,0,0,0,0,0,USA
12006,49.99,0,0,0,0,0,0,0,USA
12200,49.99,0,0,0,0,0,0,0,USA
11327,24.99,6,0,0,0,0,0,99998,USA
12196,29.99,6,0,0,0,0,0,99998,USA
12204,44.99,6,0,0,0,0,0,99998,USA
12206,44.99,12,0,0,0,0,0,99998,USA
12201,44.99,18,0,0,0,0,0,99998,USA
11991,29.99,6,0,0,0,0,0,99998,USA
12197,29.99,8,2,1,0,1,4,2.25,USA
12205,49.99,8,0,0,0,1,1,8,USA
12207,44.99,11,0,0,0,0,0,99998,USA
12199,39.99,1,2,1,3,0,6,0.17,USA
12233,19.99,5,0,0,0,0,0,99998,USA
12176,44.99,30,0,0,0,0,0,99998,USA
12174,59.99,60,0,0,0,0,0,99998,USA
12172,69.99,30,0,0,0,0,0,99998,USA
12039,14.99,20,0,0,0,0,0,99998,USA
12215,14.99,5,0,0,0,0,0,99998,USA
12216,14.99,4,0,0,0,0,0,99998,USA
12217,19.99,5,0,0,0,0,0,99998,USA
12225,29.99,6,0,0,0,0,0,99998,USA
12226,29.99,6,0,0,0,0,0,99998,USA
12227,39.99,6,0,0,0,0,0,99998,USA
12228,39.99,6,0,0,0,0,0,99998,USA
12229,69.99,4,1,1,0,0,2,2,USA
12230,74.99,6,0,0,0,0,0,99998,USA
12231,44.99,6,0,0,0,0,0,99998,USA
12232,44.99,6,0,0,0,0,0,99998,USA
11555,19.99,5,0,0,0,0,0,99998,USA
12234,19.99,8,1,0,1,0,2,4,USA
12235,24.99,4,0,0,0,0,0,99998,USA
12237,19.99,5,0,0,0,0,0,99998,USA
12238,24.99,5,0,0,0,0,0,99998,USA
12239,24.99,5,0,0,0,0,0,99998,USA
11823,29.99,19,0,0,0,0,0,99998,USA
11486,17.99,54,70,21,2,0,93,0.83,USA
11298,89.99,0,0,0,0,0,0,0,USA
11299,89.99,0,0,0,0,0,0,0,USA
10103,89.99,0,0,0,0,0,0,0,USA
10716,4.99,79,0,0,0,1,1,79,USA
12139,4.99,79,0,0,1,0,1,79,USA
12140,4.99,75,2,2,1,0,5,15,USA
12166,21.99,65,1,5,2,6,14,4.64,USA
12037,19.99,10,0,0,0,0,0,99998,USA
12224,19.99,5,0,0,0,0,0,99998,USA
,0,0,0,0,0,0,0,0,USA
12045,14.99,0,0,0,0,0,0,0,USA
11144,7.99,0,0,0,0,0,0,0,USA
11133,0,0,0,0,0,0,0,0,USA
11134,9.99,0,0,0,0,0,0,0,USA
12163,0,0,0,0,0,0,0,0,USA
